가	ec	가
거냐	ec	거냐
거늘	ec	거늘
거니	ec	거니
거니와	ec	거니와
거던	ec	거던
거든	ec	거든
거든요	ec	거든요
거들랑	ec	거들랑
거라	ec	거라
건대	ec	건대
건데	ec	건데
건마는	ec	건마는
건만	ec	건만
게끔	ec	게끔
게든	ec	게든
게든지	ec	게든지
게라고	ec	게라고
게라도	ec	게라도
게시리	ec	게시리
게요	ec	게요
고는	ec	고는
고라니	ec	고라니
고라도	ec	고라도
고만요	ec	고만요
고서라도	ec	고서라도
고서리	ec	고서리
고야	ec	고야
관데	ec	관데
구나	ec	구나
구려	ec	구려
구료	ec	구료
구마는	ec	구마는
구만	ec	구만
구먼	ec	구먼
구요	ec	구요
군요	ec	군요
굼지서	ec	굼지서
기로서니	ec	기로서니
기에	ec	기에
길래	ec	길래
까	ec	까
까요	ec	까요
나니	ec	나니
나마	ec	나마
나마나	ec	나마나
나요	ec	나요
나이까	ec	나이까
나이다	ec	나이다
나지	ec	나지
냐고	ec	냐고
냐구	ec	냐구
냐느니	ec	냐느니
냐는데	ec	냐는데
냐며	ec	냐며
냐면	ec	냐면
냐면서	ec	냐면서
너라	ec	너라
너라고	ec	너라고
네라고	ec	네라고
네요	ec	네요
노니	ec	노니
노라	ec	노라
노라고	ec	노라고
노라니	ec	노라니
노라면	ec	노라면
느냐	ec	느냐
느냐고	ec	느냐고
느냐구	ec	느냐구
느냐니까	ec	느냐니까
느냐며	ec	느냐며
느냐면서	ec	느냐면서
느니	ec	느니
느니라	ec	느니라
느니만	ec	느니만
느라	ec	느라
느라고	ec	느라고
느라구	ec	느라구
느라니까	ec	느라니까
는가	ec	는가
는가고	ec	는가고
는가라고	ec	는가라고
는가시피	ec	는가시피
는고	ec	는고
는구나	ec	는구나
는구먼	ec	는구먼
는군	ec	는군
는다	ec	는다
는다거나	ec	는다거나
는다고	ec	는다고
는다구	ec	는다구
는다느니	ec	는다느니
는다는데	ec	는다는데
는다니	ec	는다니
는다든가	ec	는다든가
는다든지	ec	는다든지
는다며	ec	는다며
는다면	ec	는다면
는다면서	ec	는다면서
는다지	ec	는다지
는다지만	ec	는다지만
는담서	ec	는담서
는대	ec	는대
는대서야	ec	는대서야
는대야	ec	는대야
는데	ec	는데
는데다	ec	는데다
는데다가	ec	는데다가
는데도	ec	는데도
는데서	ec	는데서
는데요	ec	는데요
는디	ec	는디
는디유	ec	는디유
는바	ec	는바
는지	ec	는지
는지라	ec	는지라
는지요	ec	는지요
니까	ec	니까
니까요	ec	니까요
니깐	ec	니깐
니께	ec	니께
니끼니	ec	니끼니
니난	ec	니난
니다	ec	니다
니라	ec	니라
니만큼	ec	니만큼
다가	ec	다가
다가는	ec	다가는
다간	ec	다간
다거나	ec	다거나
다고	ec	다고
다고는	ec	다고는
다구요	ec	다구요
다기로서니	ec	다기로서니
다기에	ec	다기에
다나	ec	다나
다나니	ec	다나니
다나면	ec	다나면
다네	ec	다네
다느니	ec	다느니
다는데	ec	다는데
다니	ec	다니
다니까	ec	다니까
다더군요	ec	다더군요
다더니	ec	다더니
다더라	ec	다더라
다던가	ec	다던가
다던데	ec	다던데
다던지	ec	다던지
다든가	ec	다든가
다든지	ec	다든지
다라고	ec	다라고
다마는	ec	다마는
다마다	ec	다마다
다며	ec	다며
다면서	ec	다면서
다손	ec	다손
다시피	ec	다시피
다오	ec	다오
다우	ec	다우
다지	ec	다지
다지만	ec	다지만
단다	ec	단다
답니다	ec	답니다
대나	ec	대나
대니까	ec	대니까
대요	ec	대요
댔자	ec	댔자
더군	ec	더군
더군요	ec	더군요
더냐	ec	더냐
더냐고	ec	더냐고
더니	ec	더니
더니만	ec	더니만
더라	ec	더라
더라고	ec	더라고
더라고요	ec	더라고요
더라구	ec	더라구
더라구요	ec	더라구요
더라니	ec	더라니
더라니까	ec	더라니까
더라니까요	ec	더라니까요
더라도	ec	더라도
더라두	ec	더라두
더라든가	ec	더라든가
더라만	ec	더라만
더라며	ec	더라며
더라면	ec	더라면
더라면서	ec	더라면서
더라지	ec	더라지
더래도	ec	더래도
더래요	ec	더래요
던가	ec	던가
던가요	ec	던가요
던고	ec	던고
던데	ec	던데
던데요	ec	던데요
던들	ec	던들
던디	ec	던디
던바	ec	던바
던지	ec	던지
던지라	ec	던지라
도다	ec	도다
드라두	ec	드라두
드래두	ec	드래두
드먼	ec	드먼
든가	ec	든가
든데	ec	든데
든동	ec	든동
든지	ec	든지
디요	ec	디요
라	ec	라
라거나	ec	라거나
라거니	ec	라거니
라고	ec	라고
라고까지	ec	라고까지
라구	ec	라구
라나	ec	라나
라네	ec	라네
라느니	ec	라느니
라는가	ec	라는가
라는데	ec	라는데
라는지	ec	라는지
라니	ec	라니
라니까	ec	라니까
라니께네	ec	라니께네
라더군요	ec	라더군요
라더니	ec	라더니
라더라	ec	라더라
라던가	ec	라던가
라던데	ec	라던데
라던지	ec	라던지
라두	ec	라두
라든	ec	라든
라든가	ec	라든가
라든지	ec	라든지
라마잉	ec	라마잉
라며	ec	라며
라면서	ec	라면서
라서	ec	라서
라서요	ec	라서요
라야	ec	라야
라요	ec	라요
라우	ec	라우
라지	ec	라지
라지만	ec	라지만
란다	ec	란다
랄까	ec	랄까
랄지	ec	랄지
랍니다	ec	랍니다
랍시고	ec	랍시고
랑께	ec	랑께
래	ec	래
래니까	ec	래니까
래도	ec	래도
래두	ec	래두
래서	ec	래서
래야	ec	래야
래요	ec	래요
래이	ec	래이
랬자	ec	랬자
랴	ec	랴
랴마는	ec	랴마는
랴셔	ec	랴셔
러	ec	러
러니	ec	러니
러면	ec	러면
런지	ec	런지
려	ec	려
려거나	ec	려거나
려거든	ec	려거든
려고	ec	려고
려구	ec	려구
려구요	ec	려구요
려나	ec	려나
려네	ec	려네
려느냐고	ec	려느냐고
려는가	ec	려는가
려는고	ec	려는고
려는데	ec	려는데
려는지	ec	려는지
려니	ec	려니
려니까	ec	려니까
려니와	ec	려니와
려다	ec	려다
려다가	ec	려다가
려도	ec	려도
려면	ec	려면
려면은	ec	려면은
려무나	ec	려무나
련가	ec	련가
련다	ec	련다
련다고	ec	련다고
렵니다	ec	렵니다
로구나	ec	로구나
로구먼	ec	로구먼
로군요	ec	로군요
로다	ec	로다
로되	ec	로되
로소이다	ec	로소이다
리니	ec	리니
리다	ec	리다
리라	ec	리라
리라고	ec	리라고
리만치	ec	리만치
리만큼	ec	리만큼
리오	ec	리오
마고	ec	마고
망정	ec	망정
며	ec	며
면서	ec	면서
므로	ec	므로
믄	ec	믄
뿐더러	ec	뿐더러
사오니	ec	사오니
세라	ec	세라
소냐	ec	소냐
소만	ec	소만
소서	ec	소서
소이다	ec	소이다
수록	ec	수록
슈	ec	슈
스므니다	ec	스므니다
습니까	ec	습니까
습니다	ec	습니다
습니다라고	ec	습니다라고
습니다마는	ec	습니다마는
습니다만	ec	습니다만
시고	ec	시고
시라	ec	시라
시와	ec	시와
심더	ec	심더
씸니더	ec	씸니더
아다	ec	아다
아다가	ec	아다가
아도	ec	아도
아두	ec	아두
아두요	ec	아두요
아라	ec	아라
아서	ec	아서
아서도	ec	아서도
아서든	ec	아서든
아서라고	ec	아서라고
아서라도	ec	아서라도
아서라두	ec	아서라두
아서요	ec	아서요
아서요라고	ec	아서요라고
아선데	ec	아선데
아선지	ec	아선지
아야	ec	아야
아야디	ec	아야디
아야만	ec	아야만
아야죠	ec	아야죠
아야지	ec	아야지
아야지라든가	ec	아야지라든가
아야지요	ec	아야지요
아요	ec	아요
아유	ec	아유
앗	ec	앗
애라고	ec	애라고
어다	ec	어다
어다가	ec	어다가
어도	ec	어도
어두	ec	어두
어라	ec	어라
어라고	ec	어라고
어모마	ec	어모마
어서든지	ec	어서든지
어서라도	ec	어서라도
어서래도	ec	어서래도
어서요	ec	어서요
어선지	ec	어선지
어시아	ec	어시아
어야	ec	어야
어야만	ec	어야만
어야지	ec	어야지
어야지요	ec	어야지요
어요	ec	어요
언만	ec	언만
언정	ec	언정
에요	ec	에요
오리까	ec	오리까
오면	ec	오면
오이다	ec	오이다
올시다	ec	올시다
옵니다	ec	옵니다
외다	ec	외다
웨다	ec	웨다
으나	ec	으나
으나마	ec	으나마
으냐	ec	으냐
으냐고	ec	으냐고
으니	ec	으니
으니까	ec	으니까
으니까요	ec	으니까요
으니깐	ec	으니깐
으니끼니	ec	으니끼니
으니라구	ec	으니라구
으니만큼	ec	으니만큼
으되	ec	으되
으라	ec	으라
으라거나	ec	으라거나
으라고	ec	으라고
으라구	ec	으라구
으라느니	ec	으라느니
으라는데	ec	으라는데
으라니까	ec	으라니까
으라면	ec	으라면
으락	ec	으락
으랴	ec	으랴
으랴마는	ec	으랴마는
으러	ec	으러
으려	ec	으려
으려고	ec	으려고
으려나	ec	으려나
으려는데	ec	으려는데
으려는지	ec	으려는지
으려니	ec	으려니
으려니까	ec	으려니까
으려니와	ec	으려니와
으려다	ec	으려다
으려다가	ec	으려다가
으려면	ec	으려면
으련만	ec	으련만
으료	ec	으료
으리	ec	으리
으리라	ec	으리라
으리라고	ec	으리라고
으리로다	ec	으리로다
으리만큼	ec	으리만큼
으리오	ec	으리오
으마	ec	으마
으매	ec	으매
으며	ec	으며
으면	ec	으면
으면서	ec	으면서
으면서도	ec	으면서도
으모	ec	으모
으므로	ec	으므로
으소서	ec	으소서
으오리까	ec	으오리까
은가	ec	은가
은가고	ec	은가고
은데	ec	은데
은데다	ec	은데다
은데다가	ec	은데다가
은들	ec	은들
은바	ec	은바
은즉	ec	은즉
은지	ec	은지
을지	ec	을지
을지니	ec	을지니
을지라도	ec	을지라도
을지언정	ec	을지언정
자느니	ec	자느니
자는데	ec	자는데
자니	ec	자니
자니까	ec	자니까
자마자	ec	자마자
자며	ec	자며
자면	ec	자면
자면서	ec	자면서
잖니	ec	잖니
잖아	ec	잖아
잖아요	ec	잖아요
죠	ec	죠
지는	ec	지는
지마는	ec	지마는
지만	ec	지만
지만요	ec	지만요
지요	ec	지요
지유	ec	지유
갑더라	ef	갑더라
게나	ef	게나
구래	ef	구래
구마는야	ef	구마는야
구만요	ef	구만요
구말구	ef	구말구
구먼요	ef	구먼요
구먼유	ef	구먼유
구먼이라우	ef	구먼이라우
구야	ef	구야
께요	ef	께요
나다	ef	나다
남유	ef	남유
냐고요	ef	냐고요
냐구요	ef	냐구요
냐니	ef	냐니
네예	ef	네예
느냐구요	ef	느냐구요
느뇨	ef	느뇨
느라구요	ef	느라구요
는가다	ef	는가다
는가요	ef	는가요
는강	ef	는강
는걸	ef	는걸
는걸요	ef	는걸요
는게	ef	는게
는구려	ef	는구려
는구만	ef	는구만
는군요	ef	는군요
는다니까	ef	는다니까
는다더군	ef	는다더군
는다던가	ef	는다던가
는다면요	ef	는다면요
는다요	ef	는다요
는단다	ef	는단다
는단대이	ef	는단대이
는답니다	ef	는답니다
는대여	ef	는대여
는대요	ef	는대요
는대유	ef	는대유
는데예	ef	는데예
는도다	ef	는도다
는디요	ef	는디요
능교	ef	능교
니더	ef	니더
다가요	ef	다가요
다고요	ef	다고요
다나요	ef	다나요
다뇨	ef	다뇨
다누만	ef	다누만
다는구나	ef	다는구나
다는군	ef	다는군
다는군요	ef	다는군요
다는데요	ef	다는데요
다니까요	ef	다니까요
다니깐요	ef	다니깐요
다니요	ef	다니요
다면서요	ef	다면서요
다야	ef	다야
다잖아	ef	다잖아
다지요	ef	다지요
답니까	ef	답니까
답디까	ef	답디까
답디다	ef	답디다
당께	ef	당께
대더라	ef	대더라
대지요	ef	대지요
댄다	ef	댄다
더구만	ef	더구만
더구만요	ef	더구만요
더구먼	ef	더구먼
더노	ef	더노
더라나	ef	더라나
더라나요	ef	더라나요
더라던데요	ef	더라던데요
더라죠	ef	더라죠
더란다	ef	더란다
더랍니다	ef	더랍니다
더래	ef	더래
더랬습니다	ef	더랬습니다
더만	ef	더만
더만요	ef	더만요
더만유	ef	더만유
던걸요	ef	던걸요
던데유	ef	던데유
던지요	ef	던지요
데요	ef	데요
두만	ef	두만
드라	ef	드라
드라구	ef	드라구
드만요	ef	드만요
든지요	ef	든지요
라고요	ef	라고요
라구요	ef	라구요
라나요	ef	라나요
라뇨	ef	라뇨
라는구나	ef	라는구나
라는군	ef	라는군
라니까요	ef	라니까요
라니요	ef	라니요
라던데요	ef	라던데요
라데	ef	라데
라리까요	ef	라리까요
라면서요	ef	라면서요
람	ef	람
래나	ef	래나
래유	ef	래유
랬잖아	ef	랬잖아
러지	ef	러지
려고요	ef	려고요
려느냐	ef	려느냐
려는구나	ef	려는구나
려는구료	ef	려는구료
려마	ef	려마
렵니까	ef	렵니까
렷다	ef	렷다
렸다	ef	렸다
로구만	ef	로구만
로군	ef	로군
리까	ef	리까
리로다	ef	리로다
면서요	ef	면서요
소이까	ef	소이까
수다래	ef	수다래
습니까요	ef	습니까요
습니꺼	ef	습니꺼
습니다요	ef	습니다요
습디까	ef	습디까
습디다	ef	습디다
습디더	ef	습디더
습매	ef	습매
습죠	ef	습죠
습지요	ef	습지요
시다레	ef	시다레
시오	ef	시오
시요	ef	시요
시유	ef	시유
아라도	ef	아라도
아서다	ef	아서다
아야잖아요	ef	아야잖아요
아야지이	ef	아야지이
애요	ef	애요
야요	ef	야요
야지	ef	야지
어라우	ef	어라우
어서다	ef	어서다
어서랴	ef	어서랴
어야죠	ef	어야죠
어여	ef	어여
어예	ef	어예
어요오	ef	어요오
어유	ef	어유
예요	ef	예요
오리오	ef	오리오
요오	ef	요오
우워	ef	우워
으네요	ef	으네요
으다	ef	으다
으라네	ef	으라네
으래요	ef	으래요
으려네	ef	으려네
으련	ef	으련
으련다	ef	으련다
으렴	ef	으렴
으렵니다	ef	으렵니다
으렷다	ef	으렷다
으면서요	ef	으면서요
으소	ef	으소
으슈	ef	으슈
은가요	ef	은가요
은걸	ef	은걸
은데요	ef	은데요
은지고	ef	은지고
을걸	ef	을걸
을걸요	ef	을걸요
을게	ef	을게
을게다	ef	을게다
을게요	ef	을게요
을께요	ef	을께요
을꼬	ef	을꼬
을씨고	ef	을씨고
읍니까	ef	읍니까
읍니다요	ef	읍니다요
읍디다	ef	읍디다
읍죠	ef	읍죠
이소	ef	이소
자구요	ef	자구요
자꾸나	ef	자꾸나
자우	ef	자우
자우요	ef	자우요
잖나	ef	잖나
잖소	ef	잖소
잖수	ef	잖수
잖습니까	ef	잖습니까
잖어	ef	잖어
즈으	ef	즈으
지러	ef	지러
지비	ef	지비
지어다	ef	지어다
지예	ef	지예
지오	ef	지오
쩌	ef	쩌
갔	ep	갔
것	ep	것
겄	ep	겄
겠	ep	겠
사오	ep	사오
시	ep	시
았	ep	았
았었	ep	았었
엇	ep	엇
었	ep	었
었었	ep	었었
오	ep	오
옵	ep	옵
으시	ep	으시
고픈	et	고픈
냐는	et	냐는
냐라는	et	냐라는
냔	et	냔
노라는	et	노라는
느냐는	et	느냐는
느냐라는	et	느냐라는
는	et	는
는가는	et	는가는
는가라는	et	는가라는
는가란	et	는가란
는다기	et	는다기
는다는	et	는다는
는단	et	는단
다는	et	다는
다더라는	et	다더라는
다던	et	다던
다라는	et	다라는
다란	et	다란
더라는	et	더라는
더라던	et	더라던
더란	et	더란
던	et	던
든	et	든
라기	et	라기
라는	et	라는
라던	et	라던
랄	et	랄
랠	et	랠
랴는	et	랴는
려는	et	려는
려던	et	려던
련다는	et	련다는
리라는	et	리라는
리라던	et	리라던
리란	et	리란
마는	et	마는
마던	et	마던
아서라기	et	아서라기
아서라는	et	아서라는
야라는	et	야라는
어서라기	et	어서라기
어요라는	et	어요라는
으냐는	et	으냐는
으라는	et	으라는
으란	et	으란
으려는	et	으려는
으려던	et	으려던
으리라는	et	으리라는
으리란	et	으리란
을까라는	et	을까라는
을까란	et	을까란
읍니까마는	et	읍니까마는
이라는	et	이라는
자는	et	자는
자던	et	자던
자라는	et	자라는
경롓	ii	경롓
그것참	ii	그것참
그래요	ii	그래요
그러엄	ii	그러엄
그럼요	ii	그럼요
그럼은요	ii	그럼은요
그렇지	ii	그렇지
그참	ii	그참
글쎄	ii	글쎄
글쎄다	ii	글쎄다
글쎄요	ii	글쎄요
기쎄	ii	기쎄
까짓거	ii	까짓거
내롱	ii	내롱
네에	ii	네에
네엣	ii	네엣
녜에	ii	녜에
니기미	ii	니기미
니미	ii	니미
뎃끼	ii	뎃끼
라랄라랄	ii	라랄라랄
맙소사	ii	맙소사
머	ii	머
무시기	ii	무시기
뭘	ii	뭘
세상에	ii	세상에
쉬잇	ii	쉬잇
쉿	ii	쉿
씨발	ii	씨발
씨부랄	ii	씨부랄
씨이	ii	씨이
씨팔	ii	씨팔
아고	ii	아고
아냐	ii	아냐
아뇨	ii	아뇨
아니야	ii	아니야
아니오	ii	아니오
아니요	ii	아니요
아따	ii	아따
아멘	ii	아멘
아무려나	ii	아무려나
아무려면	ii	아무려면
아무렴	ii	아무렴
아뿔사	ii	아뿔사
아뿔싸	ii	아뿔싸
아서라	ii	아서라
아소	ii	아소
아아뇨	ii	아아뇨
아아니	ii	아아니
아아씨	ii	아아씨
아암	ii	아암
아앙	ii	아앙
아얏	ii	아얏
아으	ii	아으
아이고	ii	아이고
아이고오	ii	아이고오
아이구	ii	아이구
아이쿠	ii	아이쿠
아차	ii	아차
아참	ii	아참
아하	ii	아하
아항	ii	아항
아휴	ii	아휴
앗다	ii	앗다
애개	ii	애개
애걔	ii	애걔
애걔걔	ii	애걔걔
애고	ii	애고
애그	ii	애그
애햄	ii	애햄
야아	ii	야아
야야	ii	야야
야호	ii	야호
얀마	ii	얀마
얏호	ii	얏호
얘	ii	얘
어거	ii	어거
어기야	ii	어기야
어디	ii	어디
어매	ii	어매
어머	ii	어머
어머나	ii	어머나
어머머	ii	어머머
어머머머	ii	어머머머
어어	ii	어어
어어이	ii	어어이
어와	ii	어와
어이구	ii	어이구
어이야	ii	어이야
어이어이	ii	어이어이
어이쿠	ii	어이쿠
어쭈	ii	어쭈
어허	ii	어허
어휴	ii	어휴
어흠	ii	어흠
억	ii	억
얼시고나	ii	얼시고나
얼싸	ii	얼싸
얼씨고나	ii	얼씨고나
얼씨구나	ii	얼씨구나
에구	ii	에구
에또	ii	에또
에라	ii	에라
에유	ii	에유
에이고	ii	에이고
에이구	ii	에이구
에이구머니	ii	에이구머니
에헴	ii	에헴
여보게	ii	여보게
여보세요	ii	여보세요
여보쇼	ii	여보쇼
여보슈	ii	여보슈
예끼	ii	예끼
예에	ii	예에
예예	ii	예예
예이	ii	예이
옛다	ii	옛다
옛소	ii	옛소
옜다	ii	옜다
오냐	ii	오냐
오라잇	ii	오라잇
오매	ii	오매
오머머	ii	오머머
오메	ii	오메
오오	ii	오오
오오냐	ii	오오냐
오호	ii	오호
올레	ii	올레
옳지	ii	옳지
옴브레	ii	옴브레
옵소	ii	옵소
옹야	ii	옹야
와아	ii	와아
용용	ii	용용
우무	ii	우무
우히히히	ii	우히히히
워매	ii	워매
워어리	ii	워어리
웬걸요	ii	웬걸요
으아	ii	으아
으악	ii	으악
으앗	ii	으앗
으앙	ii	으앙
으음	ii	으음
으응	ii	으응
으헤헤	ii	으헤헤
으흠으흠	ii	으흠으흠
으흥	ii	으흥
응아	ii	응아
응응	ii	응응
이그	ii	이그
이러언	ii	이러언
이보슈	ii	이보슈
이봐	ii	이봐
이봐라	ii	이봐라
이애	ii	이애
이잉	ii	이잉
익익	ii	익익
임마	ii	임마
제기랄	ii	제기랄
제길	ii	제길
제미	ii	제미
제미랄	ii	제미랄
젠장	ii	젠장
좋아	ii	좋아
지미씨팔	ii	지미씨팔
짜샤	ii	짜샤
쯧쯧쯧	ii	쯧쯧쯧
차려	ii	차려
천만에	ii	천만에
쳇	ii	쳇
칫	ii	칫
캬	ii	캬
피이	ii	피이
하이고	ii	하이고
하하	ii	하하
하하핫	ii	하하핫
하핫	ii	하핫
핫핫	ii	핫핫
햐	ii	햐
햐아	ii	햐아
허어	ii	허어
헛헛헛	ii	헛헛헛
호오	ii	호오
호호	ii	호호
호호호	ii	호호호
후여	ii	후여
후우	ii	후우
후이	ii	후이
후훗	ii	후훗
휴우	ii	휴우
흐응	ii	흐응
흐흥	ii	흐흥
흑흑흑	ii	흑흑흑
히야	ii	히야
게도	jc	게도
게만	jc	게만
과	jc	과
과는	jc	과는
과의	jc	과의
까지나	jc	까지나
까지는	jc	까지는
까지도	jc	까지도
까지라도	jc	까지라도
까지로	jc	까지로
까지를	jc	까지를
까지만	jc	까지만
까지만을	jc	까지만을
까지만의	jc	까지만의
까지만이라도	jc	까지만이라도
까지와는	jc	까지와는
까지요	jc	까지요
까지의	jc	까지의
께로 부터	jc	께로부터
께로부터	jc	께로부터
께로의	jc	께로의
께만의	jc	께만의
께서	jc	께서
께서는	jc	께서는
께오서	jc	께오서
께옵서	jc	께옵서
대로	jc	대로
대로요	jc	대로요
대로의	jc	대로의
대론	jc	대론
라고도	jc	라고도
라고만	jc	라고만
라고만도	jc	라고만도
란	jc	란
랑	jc	랑
랑은	jc	랑은
로나	jc	로나
로는	jc	로는
로도	jc	로도
로부터	jc	로부터
로부터는	jc	로부터는
로부터의	jc	로부터의
로서	jc	로서
로서는	jc	로서는
로서의	jc	로서의
로선	jc	로선
로써	jc	로써
로써의	jc	로써의
로요	jc	로요
로의	jc	로의
를	jc	를
마다로 부터	jc	마다로부터
마다로부터	jc	마다로부터
마다에게	jc	마다에게
마다의	jc	마다의
마따나	jc	마따나
마저도	jc	마저도
만도	jc	만도
만에	jc	만에
만요	jc	만요
만으로	jc	만으로
만으로는	jc	만으로는
만으로도	jc	만으로도
만으로서	jc	만으로서
만으로서의	jc	만으로서의
만은	jc	만은
만을	jc	만을
만의	jc	만의
만이	jc	만이
만이라도	jc	만이라도
말고는	jc	말고는
말고도	jc	말고도
밖엔	jc	밖엔
보구	jc	보구
보다는	jc	보다는
보다도	jc	보다도
보담	jc	보담
부터 라도	jc	부터라도
부터 서는	jc	부터서는
부터는	jc	부터는
부터도	jc	부터도
부터라도	jc	부터라도
부터서는	jc	부터서는
뿐만	jc	뿐만
서 부터도	jc	서부터도
서건	jc	서건
서는	jc	서는
서도	jc	서도
서부터	jc	서부터
서부터도	jc	서부터도
서의	jc	서의
스런	jc	스런
시여	jc	시여
에게	jc	에게
에게까지	jc	에게까지
에게나	jc	에게나
에게는	jc	에게는
에게도	jc	에게도
에게로	jc	에게로
에게만	jc	에게만
에게서	jc	에게서
에게선	jc	에게선
에겐	jc	에겐
에겐가	jc	에겐가
에겐가는	jc	에겐가는
에겐가로	jc	에겐가로
에까지	jc	에까지
에까지는	jc	에까지는
에나	jc	에나
에는	jc	에는
에다	jc	에다
에다가	jc	에다가
에도	jc	에도
에만	jc	에만
에만도	jc	에만도
에서	jc	에서
에서 부터	jc	에서부터
에서 부터는	jc	에서부터는
에서 부터도	jc	에서부터도
에서 부터만	jc	에서부터만
에서 부터만은	jc	에서부터만은
에서나	jc	에서나
에서는	jc	에서는
에서도	jc	에서도
에서든지	jc	에서든지
에서만	jc	에서만
에서만도	jc	에서만도
에서만은	jc	에서만은
에서부터	jc	에서부터
에서부터 만도	jc	에서부터만도
에서부터는	jc	에서부터는
에서부터도	jc	에서부터도
에서부터만	jc	에서부터만
에서부터만도	jc	에서부터만도
에서부터만은	jc	에서부터만은
에서의	jc	에서의
에선	jc	에선
에야	jc	에야
와는	jc	와는
와도	jc	와도
와의	jc	와의
으로	jc	으로
으로 부터	jc	으로부터
으로 부터는	jc	으로부터는
으로는	jc	으로는
으로도	jc	으로도
으로만	jc	으로만
으로부터	jc	으로부터
으로부터는	jc	으로부터는
으로서	jc	으로서
으로서는	jc	으로서는
으로서도	jc	으로서도
으로서의	jc	으로서의
으로써	jc	으로써
으로요	jc	으로요
으로한	jc	으로한
으론	jc	으론
으루	jc	으루
은랑	jc	은랑
은요	jc	은요
이	jc	이
이가	jc	이가
이건	jc	이건
이고	jc	이고
이나	jc	이나
이는	jc	이는
이든	jc	이든
이든지	jc	이든지
이라거나	jc	이라거나
이라고	jc	이라고
이라고는	jc	이라고는
이라고도	jc	이라고도
이라도	jc	이라도
이라면서	jc	이라면서
이라서	jc	이라서
이란	jc	이란
이란게	jc	이란게
이랑	jc	이랑
이를	jc	이를
이며	jc	이며
이부터	jc	이부터
이시여	jc	이시여
이에게	jc	이에게
이에게도	jc	이에게도
이여	jc	이여
이와	jc	이와
이와도	jc	이와도
이지만	jc	이지만
조차도	jc	조차도
처럼	jc	처럼
하고	jc	하고
하고야	jc	하고야
한테	jc	한테
한테도	jc	한테도
한테로	jc	한테로
한테서	jc	한테서
한테서 부터	jc	한테서부터
한테서부터	jc	한테서부터
까지	jx	까지
깨나	jx	깨나
꺼정	jx	꺼정
는커녕	jx	는커녕
따라	jx	따라
밖에	jx	밖에
부터	jx	부터
야말로	jx	야말로
은커녕	jx	은커녕
이야	jx	이야
이야말로	jx	이야말로
치고	jx	치고
커녕	jx	커녕
가급적	ma	가급적
가까스로	ma	가까스로
가까이	ma	가까이
가끔	ma	가끔
가끔 가끔	ma	가끔가끔
가끔 가다	ma	가끔가다
가끔가끔	ma	가끔가끔
가끔가다	ma	가끔가다
가닥가닥	ma	가닥가닥
가득	ma	가득
가득가득	ma	가득가득
가득히	ma	가득히
가뜩이나	ma	가뜩이나
가령	ma	가령
가로	ma	가로
가르랑	ma	가르랑
가만	ma	가만
가만가만	ma	가만가만
가만히	ma	가만히
가물가물	ma	가물가물
가벼이	ma	가벼이
가부간	ma	가부간
가뿐히	ma	가뿐히
가상히	ma	가상히
가엾이	ma	가엾이
가장	ma	가장
가지런히	ma	가지런히
가히	ma	가히
각각	ma	각각
각기	ma	각기
각별히	ma	각별히
각설	ma	각설
간간	ma	간간
간간이	ma	간간이
간곡히	ma	간곡히
간단히	ma	간단히
간드랑	ma	간드랑
간략히	ma	간략히
간신히	ma	간신히
간실간실	ma	간실간실
간절히	ma	간절히
간질간질	ma	간질간질
간편히	ma	간편히
간혹	ma	간혹
갈가리	ma	갈가리
갈기갈기	ma	갈기갈기
갈수록	ma	갈수록
갈팡질팡	ma	갈팡질팡
갉작 갉작	ma	갉작갉작
갉작갉작	ma	갉작갉작
감연히	ma	감연히
감쪽같이	ma	감쪽같이
감히	ma	감히
갑자기	ma	갑자기
갑작스레	ma	갑작스레
강경히	ma	강경히
강력히	ma	강력히
같이	ma	같이
개굴 개굴	ma	개굴개굴
개굴개굴	ma	개굴개굴
갸르르	ma	갸르르
갸우뚱	ma	갸우뚱
거꾸로	ma	거꾸로
거듭	ma	거듭
거듭 거듭	ma	거듭거듭
거듭거듭	ma	거듭거듭
거뜬히	ma	거뜬히
거뭇거뭇	ma	거뭇거뭇
거반	ma	거반
거의	ma	거의
거저	ma	거저
거지반	ma	거지반
거진	ma	거진
거침없이	ma	거침없이
거푸	ma	거푸
건성건성	ma	건성건성
걸핏 하면	ma	걸핏하면
걸핏하면	ma	걸핏하면
게다가	ma	게다가
게을리	ma	게을리
겨우	ma	겨우
겨우내	ma	겨우내
격렬히	ma	격렬히
격하게	ma	격하게
격한	ma	격한
견고히	ma	견고히
결국	ma	결국
결단코	ma	결단코
결연히	ma	결연히
결코	ma	결코
겸허히	ma	겸허히
겹겹이	ma	겹겹이
경건히	ma	경건히
경솔히	ma	경솔히
고래 고래	ma	고래고래
고래고래	ma	고래고래
고래로	ma	고래로
고로	ma	고로
고루고루	ma	고루고루
고만	ma	고만
고분고분	ma	고분고분
고사하고	ma	고사하고
고생스레	ma	고생스레
고스란히	ma	고스란히
고요히	ma	고요히
고작	ma	고작
고즈넉이	ma	고즈넉이
고집스레	ma	고집스레
곤드레만드레	ma	곤드레만드레
곤히	ma	곤히
곧	ma	곧
곧대로	ma	곧대로
곧바로	ma	곧바로
곧이	ma	곧이
곧이곧대로	ma	곧이곧대로
곧이어	ma	곧이어
곧잘	ma	곧잘
곧장	ma	곧장
곧추	ma	곧추
골고루	ma	골고루
골똘히	ma	골똘히
골몰스레	ma	골몰스레
곰곰	ma	곰곰
곰곰이	ma	곰곰이
곰곰히	ma	곰곰히
곰슬곰슬	ma	곰슬곰슬
곱슬곱슬	ma	곱슬곱슬
곱실곱실	ma	곱실곱실
공고히	ma	공고히
공공연히	ma	공공연히
공손히	ma	공손히
공연히	ma	공연히
공평히	ma	공평히
공히	ma	공히
과감히	ma	과감히
과연	ma	과연
관계 없이	ma	관계없이
관계없이	ma	관계없이
관대히	ma	관대히
광범히	ma	광범히
괜스리	ma	괜스리
괜시리	ma	괜시리
괜히	ma	괜히
굉장히	ma	굉장히
교묘히	ma	교묘히
구비구비	ma	구비구비
구질구질	ma	구질구질
구태어	ma	구태어
구태여	ma	구태여
군데군데	ma	군데군데
굳건히	ma	굳건히
굳이	ma	굳이
굽신굽신	ma	굽신굽신
굽이굽이	ma	굽이굽이
궁금히	ma	궁금히
귀히	ma	귀히
그나	ma	그나
그나마	ma	그나마
그나저나	ma	그나저나
그냥	ma	그냥
그냥 저냥	ma	그냥저냥
그냥저냥	ma	그냥저냥
그다지	ma	그다지
그대로	ma	그대로
그대루	ma	그대루
그득	ma	그득
그득히	ma	그득히
그때그때	ma	그때그때
그때껏	ma	그때껏
그라고	ma	그라고
그라머	ma	그라머
그래	ma	그래
그래도	ma	그래도
그래두	ma	그래두
그래서	ma	그래서
그래야	ma	그래야
그러구	ma	그러구
그러나	ma	그러나
그러나저러나	ma	그러나저러나
그러니	ma	그러니
그러니까	ma	그러니까
그러니끼니	ma	그러니끼니
그러다가	ma	그러다가
그러더니	ma	그러더니
그러면	ma	그러면
그러면서	ma	그러면서
그러므로	ma	그러므로
그러자	ma	그러자
그러잖아도	ma	그러잖아도
그러잖아두	ma	그러잖아두
그러저럭	ma	그러저럭
그럭 저럭	ma	그럭저럭
그럭저럭	ma	그럭저럭
그런대로	ma	그런대로
그런데	ma	그런데
그런데로	ma	그런데로
그럼	ma	그럼
그렁그렁	ma	그렁그렁
그렇게	ma	그렇게
그렇다면	ma	그렇다면
그렇지만	ma	그렇지만
그리	ma	그리
그리고	ma	그리고
그리구	ma	그리구
그리도	ma	그리도
그리로	ma	그리로
그리하여	ma	그리하여
그만치	ma	그만치
그만큼	ma	그만큼
그야말로	ma	그야말로
그예	ma	그예
그윽히	ma	그윽히
그저	ma	그저
그제사	ma	그제사
그제서	ma	그제서
그제서야	ma	그제서야
그제야	ma	그제야
그지 없이	ma	그지없이
그지없이	ma	그지없이
그토록	ma	그토록
극구	ma	극구
극명히	ma	극명히
극악스레	ma	극악스레
극진히	ma	극진히
극히	ma	극히
근간히	ma	근간히
근근이	ma	근근이
근근히	ma	근근히
근데	ma	근데
근질근질	ma	근질근질
금방	ma	금방
금새	ma	금새
금세	ma	금세
급격히	ma	급격히
급기야	ma	급기야
급속이	ma	급속이
급속히	ma	급속히
급작스레	ma	급작스레
급작히	ma	급작히
급히	ma	급히
기꺼이	ma	기꺼이
기껏	ma	기껏
기껏 해야	ma	기껏해야
기껏해야	ma	기껏해야
기러니끼니	ma	기러니끼니
기런데	ma	기런데
기리	ma	기리
기실	ma	기실
기어이	ma	기어이
기어코	ma	기어코
기왕 이면	ma	기왕이면
기왕에	ma	기왕에
기왕이면	ma	기왕이면
기우뚱	ma	기우뚱
기웃	ma	기웃
기웃이	ma	기웃이
기탄없이	ma	기탄없이
기필코	ma	기필코
긴급히	ma	긴급히
긴데	ma	긴데
긴밀히	ma	긴밀히
긴히	ma	긴히
길길이	ma	길길이
길이길이	ma	길이길이
깊숙이	ma	깊숙이
깊숙히	ma	깊숙히
깊이	ma	깊이
깊이깊이	ma	깊이깊이
까딱	ma	까딱
까르르	ma	까르르
까르륵	ma	까르륵
까마득히	ma	까마득히
까빡까빡	ma	까빡까빡
까슬까슬	ma	까슬까슬
깍	ma	깍
깍듯이	ma	깍듯이
깔깔깔	ma	깔깔깔
깔깔깔깔	ma	깔깔깔깔
깜냥껏	ma	깜냥껏
깜박	ma	깜박
깜빡	ma	깜빡
깜작	ma	깜작
깜짝	ma	깜짝
깜짝 깜짝	ma	깜짝깜짝
깜짝깜짝	ma	깜짝깜짝
깜쪽같이	ma	깜쪽같이
깡그리	ma	깡그리
깡깡 깡깡	ma	깡깡깡깡
깡깡깡깡	ma	깡깡깡깡
깡충 깡충	ma	깡충깡충
깡충깡충	ma	깡충깡충
깨끗이	ma	깨끗이
꺼꾸로	ma	꺼꾸로
꺼떡	ma	꺼떡
꺼뻑	ma	꺼뻑
껄껄	ma	껄껄
껌벅껌벅	ma	껌벅껌벅
껌뻑	ma	껌뻑
껍죽껍죽	ma	껍죽껍죽
껍진껍진	ma	껍진껍진
껑충 껑충	ma	껑충껑충
껑충껑충	ma	껑충껑충
꼬깃꼬깃	ma	꼬깃꼬깃
꼬꼬	ma	꼬꼬
꼬들꼬들	ma	꼬들꼬들
꼬르르	ma	꼬르르
꼬박	ma	꼬박
꼬박꼬박	ma	꼬박꼬박
꼬불꼬불	ma	꼬불꼬불
꼬옥	ma	꼬옥
꼬치꼬치	ma	꼬치꼬치
꼭	ma	꼭
꼭꼭	ma	꼭꼭
꼴깍	ma	꼴깍
꼼꼼히	ma	꼼꼼히
꼼작	ma	꼼작
꼼지락 꼼지락	ma	꼼지락꼼지락
꼼지락꼼지락	ma	꼼지락꼼지락
꼼짝	ma	꼼짝
꼼짝달싹	ma	꼼짝달싹
꼼짝없이	ma	꼼짝없이
꼿꼿이	ma	꼿꼿이
꽁꽁	ma	꽁꽁
꽁꽁꽁꽁꽁	ma	꽁꽁꽁꽁꽁
꽉	ma	꽉
꽉꽉	ma	꽉꽉
꽝	ma	꽝
꽤	ma	꽤
꽥	ma	꽥
꾸득 꾸득	ma	꾸득꾸득
꾸득꾸득	ma	꾸득꾸득
꾸루륵	ma	꾸루륵
꾸룩 꾸룩	ma	꾸룩꾸룩
꾸룩꾸룩	ma	꾸룩꾸룩
꾸르럭	ma	꾸르럭
꾸르르	ma	꾸르르
꾸륵	ma	꾸륵
꾸밈없이	ma	꾸밈없이
꾸벅	ma	꾸벅
꾸벅 꾸벅	ma	꾸벅꾸벅
꾸벅꾸벅	ma	꾸벅꾸벅
꾸부정히	ma	꾸부정히
꾸불 꾸불	ma	꾸불꾸불
꾸불꾸불	ma	꾸불꾸불
꾸뻑	ma	꾸뻑
꾸역꾸역	ma	꾸역꾸역
꾸준히	ma	꾸준히
꾹	ma	꾹
꾹꾹	ma	꾹꾹
꿀걱	ma	꿀걱
꿀꺽	ma	꿀꺽
꿀꺽 꿀꺽	ma	꿀꺽꿀꺽
꿀꺽꿀꺽	ma	꿀꺽꿀꺽
꿀꿀	ma	꿀꿀
꿀떡	ma	꿀떡
꿈적	ma	꿈적
꿈쩍	ma	꿈쩍
꿈틀	ma	꿈틀
꿈틀 꿈틀	ma	꿈틀꿈틀
꿈틀꿈틀	ma	꿈틀꿈틀
꿋꿋이	ma	꿋꿋이
꿍꿍	ma	꿍꿍
끄덕	ma	끄덕
끄덕 끄덕	ma	끄덕끄덕
끄덕끄덕	ma	끄덕끄덕
끄떡	ma	끄떡
끄떡없이	ma	끄떡없이
끈적끈적	ma	끈적끈적
끊임 없이	ma	끊임없이
끊임없이	ma	끊임없이
끌끌	ma	끌끌
끔찍이	ma	끔찍이
끔찍히	ma	끔찍히
끗끗이	ma	끗끗이
끙끙	ma	끙끙
끝끝내	ma	끝끝내
끝내	ma	끝내
끝없이	ma	끝없이
끼득끼득	ma	끼득끼득
끼르륵	ma	끼르륵
끼리 끼리	ma	끼리끼리
끼리끼리	ma	끼리끼리
끼익	ma	끼익
끽	ma	끽
낄낄	ma	낄낄
낄낄낄	ma	낄낄낄
낑낑	ma	낑낑
나날이	ma	나날이
나달 나달	ma	나달나달
나달나달	ma	나달나달
나들 나들	ma	나들나들
나들나들	ma	나들나들
나란히	ma	나란히
나른히	ma	나른히
나몰라라	ma	나몰라라
나즉히	ma	나즉히
나지막이	ma	나지막이
나직 나직	ma	나직나직
나직나직	ma	나직나직
나직히	ma	나직히
낙케	ma	낙케
난데 없이	ma	난데없이
난데없이	ma	난데없이
난생	ma	난생
날강 날강	ma	날강날강
날강날강	ma	날강날강
날로	ma	날로
날쭉	ma	날쭉
남김없이	ma	남김없이
남달리	ma	남달리
남몰래	ma	남몰래
납작납작	ma	납작납작
납죽이	ma	납죽이
납짝	ma	납짝
낱낱이	ma	낱낱이
내남없이	ma	내남없이
내내	ma	내내
내롱 내롱	ma	내롱내롱
내롱내롱	ma	내롱내롱
내리	ma	내리
내지	ma	내지
내처	ma	내처
낼름	ma	낼름
냅다	ma	냅다
냉정히	ma	냉정히
냉철히	ma	냉철히
냉큼	ma	냉큼
냠냠	ma	냠냠
너끈히	ma	너끈히
너나없이	ma	너나없이
너덜너덜	ma	너덜너덜
너도 나도	ma	너도나도
너도나도	ma	너도나도
너무	ma	너무
너무 너무	ma	너무너무
너무나	ma	너무나
너무너무	ma	너무너무
너울 너울	ma	너울너울
너울너울	ma	너울너울
넉넉히	ma	넉넉히
넌지시	ma	넌지시
널리	ma	널리
넙죽	ma	넙죽
노피곰	ma	노피곰
높이	ma	높이
누누이	ma	누누이
누덕 누덕	ma	누덕누덕
누덕누덕	ma	누덕누덕
누차	ma	누차
눅눅히	ma	눅눅히
눈치껏	ma	눈치껏
뉘엿 뉘엿	ma	뉘엿뉘엿
뉘엿뉘엿	ma	뉘엿뉘엿
느긋이	ma	느긋이
느닷없이	ma	느닷없이
느릿느릿	ma	느릿느릿
느물 느물	ma	느물느물
느물느물	ma	느물느물
느슨히	ma	느슨히
늘	ma	늘
늘상	ma	늘상
능력껏	ma	능력껏
능히	ma	능히
다	ma	다
다글 다글	ma	다글다글
다글다글	ma	다글다글
다급히	ma	다급히
다닥다닥	ma	다닥다닥
다닥딱딱	ma	다닥딱딱
다달이	ma	다달이
다름 없이	ma	다름없이
다름없이	ma	다름없이
다만	ma	다만
다분히	ma	다분히
다소곧이	ma	다소곧이
다소곳이	ma	다소곳이
다시	ma	다시
다시금	ma	다시금
다아	ma	다아
다정스레	ma	다정스레
다정히	ma	다정히
다짜고짜	ma	다짜고짜
다짜고짜로	ma	다짜고짜로
다행이	ma	다행이
다행히	ma	다행히
단걸음에	ma	단걸음에
단김에	ma	단김에
단단히	ma	단단히
단번에	ma	단번에
단순히	ma	단순히
단숨에	ma	단숨에
단연	ma	단연
단연코	ma	단연코
단정히	ma	단정히
단지	ma	단지
단호히	ma	단호히
달달	ma	달달
달랑	ma	달랑
달랑달랑	ma	달랑달랑
달리	ma	달리
달칵	ma	달칵
담담히	ma	담담히
당당히	ma	당당히
당분간	ma	당분간
당싯	ma	당싯
당연히	ma	당연히
당최	ma	당최
대강	ma	대강
대개	ma	대개
대거	ma	대거
대관절	ma	대관절
대굴 대굴	ma	대굴대굴
대굴대굴	ma	대굴대굴
대놓고	ma	대놓고
대단히	ma	대단히
대담히	ma	대담히
대대로	ma	대대로
대뜸	ma	대뜸
대략	ma	대략
대롱 대롱	ma	대롱대롱
대롱대롱	ma	대롱대롱
대번에	ma	대번에
대저	ma	대저
대체	ma	대체
대체로	ma	대체로
대충	ma	대충
대충대충	ma	대충대충
대폭	ma	대폭
댕	ma	댕
댕강	ma	댕강
더	ma	더
더구나	ma	더구나
더군다나	ma	더군다나
더더구나	ma	더더구나
더더욱	ma	더더욱
더덕 더덕	ma	더덕더덕
더덕더덕	ma	더덕더덕
더덜 없이	ma	더덜없이
더덜없이	ma	더덜없이
더디	ma	더디
더러	ma	더러
더러 더러	ma	더러더러
더러더러	ma	더러더러
더없이	ma	더없이
더우기	ma	더우기
더욱	ma	더욱
더욱더	ma	더욱더
더욱이	ma	더욱이
더한층	ma	더한층
덕지 덕지	ma	덕지덕지
덕지덕지	ma	덕지덕지
덜	ma	덜
덜덜	ma	덜덜
덜렁	ma	덜렁
덜렁 덜렁	ma	덜렁덜렁
덜렁덜렁	ma	덜렁덜렁
덜레 덜레	ma	덜레덜레
덜레덜레	ma	덜레덜레
덜커덕	ma	덜커덕
덜커덩	ma	덜커덩
덜컥	ma	덜컥
덜컹	ma	덜컹
덤덤히	ma	덤덤히
덥석	ma	덥석
덥석 덥석	ma	덥석덥석
덥석덥석	ma	덥석덥석
덥썩	ma	덥썩
덩실 덩실	ma	덩실덩실
덩실덩실	ma	덩실덩실
뎅그랑	ma	뎅그랑
도대체	ma	도대체
도도히	ma	도도히
도란 도란	ma	도란도란
도란도란	ma	도란도란
도로	ma	도로
도리 도리	ma	도리도리
도리도리	ma	도리도리
도리어	ma	도리어
도무지	ma	도무지
도저히	ma	도저히
독특히	ma	독특히
돈독히	ma	돈독히
돈돈돈	ma	돈돈돈
돌돌	ma	돌돌
돌돌돌	ma	돌돌돌
돌연	ma	돌연
돌연히	ma	돌연히
동글동글	ma	동글동글
동동	ma	동동
되도록	ma	되도록
되레	ma	되레
된통	ma	된통
두고 두고	ma	두고두고
두고두고	ma	두고두고
두두둑	ma	두두둑
두둑이	ma	두둑이
두둑히	ma	두둑히
두둥실	ma	두둥실
두루	ma	두루
두루 두루	ma	두루두루
두루두루	ma	두루두루
두리 둥실	ma	두리둥실
두리둥실	ma	두리둥실
두릿 두릿	ma	두릿두릿
두릿두릿	ma	두릿두릿
두말 없이	ma	두말없이
두말없이	ma	두말없이
두서 없이	ma	두서없이
두서없이	ma	두서없이
두터이	ma	두터이
두툼히	ma	두툼히
둘둘	ma	둘둘
둘레 둘레	ma	둘레둘레
둘레둘레	ma	둘레둘레
둥글 둥글	ma	둥글둥글
둥글둥글	ma	둥글둥글
둥기당	ma	둥기당
둥둥	ma	둥둥
뒤미처	ma	뒤미처
드높이	ma	드높이
드디어	ma	드디어
드르륵	ma	드르륵
드리도록시키다	ma	드리도록시키다
드문 드문	ma	드문드문
드문드문	ma	드문드문
드윽	ma	드윽
들들	ma	들들
들락 날락	ma	들락날락
들락날락	ma	들락날락
들쑥 날쑥	ma	들쑥날쑥
들쑥날쑥	ma	들쑥날쑥
들어앉도록시키다	ma	들어앉도록시키다
들어오도록시키다	ma	들어오도록시키다
들쭉	ma	들쭉
들쭉 날쭉	ma	들쭉날쭉
들쭉날쭉	ma	들쭉날쭉
듬뿍	ma	듬뿍
듬뿍 듬뿍	ma	듬뿍듬뿍
듬뿍듬뿍	ma	듬뿍듬뿍
듬성 듬성	ma	듬성듬성
듬성듬성	ma	듬성듬성
등한히	ma	등한히
디룩 디룩	ma	디룩디룩
디룩디룩	ma	디룩디룩
디리	ma	디리
딛도록시키다	ma	딛도록시키다
딩	ma	딩
딩동댕	ma	딩동댕
따그락	ma	따그락
따글 따글	ma	따글따글
따글따글	ma	따글따글
따끈 따끈	ma	따끈따끈
따끈따근	ma	따끈따근
따끈따끈	ma	따끈따끈
따끔따끔	ma	따끔따끔
따닥따닥	ma	따닥따닥
따독 따독	ma	따독따독
따독따독	ma	따독따독
따뜻이	ma	따뜻이
따라붙도록시키다	ma	따라붙도록시키다
따라서	ma	따라서
따로	ma	따로
따로따로	ma	따로따로
따로이	ma	따로이
따루	ma	따루
따르르릉	ma	따르르릉
따르륵	ma	따르륵
따르릉	ma	따르릉
따악	ma	따악
딱	ma	딱
딱히	ma	딱히
딴은	ma	딴은
딸그락	ma	딸그락
딸랑 딸랑	ma	딸랑딸랑
딸랑딸랑	ma	딸랑딸랑
때굴 때굴	ma	때굴때굴
때굴때굴	ma	때굴때굴
때때로	ma	때때로
때뚝	ma	때뚝
때로	ma	때로
때마침	ma	때마침
땜시	ma	땜시
땡글 땡글	ma	땡글땡글
땡글땡글	ma	땡글땡글
땡땡	ma	땡땡
떠듬 떠듬	ma	떠듬떠듬
떠듬떠듬	ma	떠듬떠듬
떨치도록시키다	ma	떨치도록시키다
떳떳이	ma	떳떳이
떼구르르	ma	떼구르르
또	ma	또
또글 또글	ma	또글또글
또글또글	ma	또글또글
또는	ma	또는
또다시	ma	또다시
또랑 또랑	ma	또랑또랑
또랑또랑	ma	또랑또랑
또렷이	ma	또렷이
또박	ma	또박
또박 또막	ma	또박또막
또박 또박	ma	또박또박
또박또막	ma	또박또막
또박또박	ma	또박또박
또옥	ma	또옥
또한	ma	또한
똑	ma	똑
똑같이	ma	똑같이
똑딱	ma	똑딱
똑똑히	ma	똑똑히
똑바로	ma	똑바로
똘망똘망	ma	똘망똘망
뚜	ma	뚜
뚜뚜뚜	ma	뚜뚜뚜
뚜렷이	ma	뚜렷이
뚜룩	ma	뚜룩
뚜룩 뚜룩	ma	뚜룩뚜룩
뚜룩뚜룩	ma	뚜룩뚜룩
뚜벅 뚜벅	ma	뚜벅뚜벅
뚜벅뚜벅	ma	뚜벅뚜벅
뚝	ma	뚝
뚝딱	ma	뚝딱
뚝뚝	ma	뚝뚝
뚤뚤	ma	뚤뚤
뜨끈 뜨끈	ma	뜨끈뜨끈
뜨끈뜨끈	ma	뜨끈뜨끈
뜨도록시키다	ma	뜨도록시키다
뜨르르	ma	뜨르르
뜻대로	ma	뜻대로
뜻밖에	ma	뜻밖에
띄도록시키다	ma	띄도록시키다
띄엄 띄엄	ma	띄엄띄엄
띄엄띄엄	ma	띄엄띄엄
띠띠	ma	띠띠
랄랄라	ma	랄랄라
릴보	ma	릴보
마구	ma	마구
마냥	ma	마냥
마땅히	ma	마땅히
마뚜루	ma	마뚜루
마악	ma	마악
마음껏	ma	마음껏
마저	ma	마저
마주	ma	마주
마치	ma	마치
마침	ma	마침
마침내	ma	마침내
막상	ma	막상
막연히	ma	막연히
막힘없이	ma	막힘없이
만날	ma	만날
만족스레	ma	만족스레
많이	ma	많이
말끔히	ma	말끔히
말똥 말똥	ma	말똥말똥
말똥말똥	ma	말똥말똥
말랑 말랑	ma	말랑말랑
말랑말랑	ma	말랑말랑
말없이	ma	말없이
말짱스레	ma	말짱스레
맘껏	ma	맘껏
맘대로	ma	맘대로
맘대루	ma	맘대루
망연히	ma	망연히
매끈매끈	ma	매끈매끈
매끌 매끌	ma	매끌매끌
매끌매끌	ma	매끌매끌
매년	ma	매년
매번	ma	매번
매우	ma	매우
매월	ma	매월
매일	ma	매일
매주	ma	매주
매초	ma	매초
매회	ma	매회
맥없이	ma	맥없이
맨날	ma	맨날
맨숭 맨숭	ma	맨숭맨숭
맨숭맨숭	ma	맨숭맨숭
맹렬히	ma	맹렬히
맹세코	ma	맹세코
머뭇머뭇	ma	머뭇머뭇
먼저	ma	먼저
멀거니	ma	멀거니
멀뚱히	ma	멀뚱히
멀리	ma	멀리
멀리곰	ma	멀리곰
멀리멀리	ma	멀리멀리
멀쩡히	ma	멀쩡히
멀찌감치	ma	멀찌감치
멀찍이	ma	멀찍이
멈칫	ma	멈칫
멋대로	ma	멋대로
멋대루	ma	멋대루
멍멍히	ma	멍멍히
멍청히	ma	멍청히
멍하니	ma	멍하니
면면이	ma	면면이
면면히	ma	면면히
면밀히	ma	면밀히
명료히	ma	명료히
명백히	ma	명백히
명쾌히	ma	명쾌히
명확히	ma	명확히
모다	ma	모다
모락 모락	ma	모락모락
모락모락	ma	모락모락
모로	ma	모로
모름지기	ma	모름지기
모조리	ma	모조리
모쪼록	ma	모쪼록
모처럼	ma	모처럼
목청껏	ma	목청껏
몰랑 몰랑	ma	몰랑몰랑
몰랑몰랑	ma	몰랑몰랑
몰래	ma	몰래
몰래몰래	ma	몰래몰래
몸소	ma	몸소
몹시	ma	몹시
몹씨	ma	몹씨
못	ma	못
못내	ma	못내
못다	ma	못다
못마땅히	ma	못마땅히
몽땅	ma	몽땅
몽창	ma	몽창
무난히	ma	무난히
무단히	ma	무단히
무던히	ma	무던히
무럭 무럭	ma	무럭무럭
무럭무럭	ma	무럭무럭
무려	ma	무려
무릇	ma	무릇
무리 무리	ma	무리무리
무리무리	ma	무리무리
무사히	ma	무사히
무수히	ma	무수히
무시로	ma	무시로
무심코	ma	무심코
무심히	ma	무심히
무여	ma	무여
무조건	ma	무조건
무지 무지	ma	무지무지
무지무지	ma	무지무지
무진장	ma	무진장
무참히	ma	무참히
무척	ma	무척
무척 이도	ma	무척이도
무척이도	ma	무척이도
무턱 대고	ma	무턱대고
무턱대고	ma	무턱대고
무한히	ma	무한히
묵묵히	ma	묵묵히
문득	ma	문득
문득 문득	ma	문득문득
문득문득	ma	문득문득
문제없이	ma	문제없이
물경	ma	물경
물끄러미	ma	물끄러미
물렁 물렁	ma	물렁물렁
물렁물렁	ma	물렁물렁
물론	ma	물론
물씬	ma	물씬
물씬 물씬	ma	물씬물씬
물씬물씬	ma	물씬물씬
물어 물어	ma	물어물어
물어물어	ma	물어물어
뭉게 뭉게	ma	뭉게뭉게
뭉게뭉게	ma	뭉게뭉게
뭉텅	ma	뭉텅
미끌미끌	ma	미끌미끌
미리	ma	미리
미약	ma	미약
미적미적	ma	미적미적
미주알 고주알	ma	미주알고주알
미주알고주알	ma	미주알고주알
미처	ma	미처
민망히	ma	민망히
밀접히	ma	밀접히
및	ma	및
바득 바득	ma	바득바득
바득바득	ma	바득바득
바로	ma	바로
바로 바로	ma	바로바로
바로바로	ma	바로바로
바루	ma	바루
바른 대로	ma	바른대로
바른대로	ma	바른대로
바삐	ma	바삐
바삭	ma	바삭
바삭 바삭	ma	바삭바삭
바삭바삭	ma	바삭바삭
바스락	ma	바스락
바스락 바스락	ma	바스락바스락
바스락바스락	ma	바스락바스락
바싹	ma	바싹
바싹 바싹	ma	바싹바싹
바싹바싹	ma	바싹바싹
바야흐로	ma	바야흐로
바작 바작	ma	바작바작
바작바작	ma	바작바작
바짝	ma	바짝
바짝 바짝	ma	바짝바짝
바짝바짝	ma	바짝바짝
박박	ma	박박
반가이	ma	반가이
반나마	ma	반나마
반드시	ma	반드시
반들 반들	ma	반들반들
반들반들	ma	반들반들
반듯이	ma	반듯이
반반히	ma	반반히
반지르르	ma	반지르르
반질 반질	ma	반질반질
반질반질	ma	반질반질
반짝	ma	반짝
반짝 반짝	ma	반짝반짝
반짝반짝	ma	반짝반짝
발그레	ma	발그레
발기 발기	ma	발기발기
발기발기	ma	발기발기
발끈	ma	발끈
발딱	ma	발딱
발랑	ma	발랑
발칵	ma	발칵
밝히	ma	밝히
밤낮	ma	밤낮
밤낮없이	ma	밤낮없이
밤새껏	ma	밤새껏
방금	ma	방금
방긋	ma	방긋
배뜸	ma	배뜸
배불리	ma	배불리
뱅그르르	ma	뱅그르르
뱅글 뱅글	ma	뱅글뱅글
뱅글뱅글	ma	뱅글뱅글
뱅뱅	ma	뱅뱅
버럭 버럭	ma	버럭버럭
버럭버럭	ma	버럭버럭
버석	ma	버석
버석 버석	ma	버석버석
버석버석	ma	버석버석
버젓이	ma	버젓이
벅벅	ma	벅벅
번들 번들	ma	번들번들
번들번들	ma	번들번들
번번이	ma	번번이
번번히	ma	번번히
번연히	ma	번연히
번지르	ma	번지르
번지르르	ma	번지르르
번쩍	ma	번쩍
번쩍 번쩍	ma	번쩍번쩍
번쩍번쩍	ma	번쩍번쩍
벌떡	ma	벌떡
벌렁	ma	벌렁
벌름 벌름	ma	벌름벌름
벌름벌름	ma	벌름벌름
벌벌	ma	벌벌
벌서	ma	벌서
벌써	ma	벌써
벌컥	ma	벌컥
벌컥 벌컥	ma	벌컥벌컥
벌컥벌컥	ma	벌컥벌컥
벙긋	ma	벙긋
변변히	ma	변변히
변함없이	ma	변함없이
별달리	ma	별달리
별로	ma	별로
별루	ma	별루
별반	ma	별반
보다	ma	보다
보송보송	ma	보송보송
보아하니	ma	보아하니
보잘것 없이	ma	보잘것없이
보잘것없이	ma	보잘것없이
보통	ma	보통
본디	ma	본디
본체만체	ma	본체만체
볼록	ma	볼록
볼록볼록	ma	볼록볼록
부걱 부걱	ma	부걱부걱
부걱부걱	ma	부걱부걱
부글 부글	ma	부글부글
부글부글	ma	부글부글
부단히	ma	부단히
부득불	ma	부득불
부득이	ma	부득이
부들부들	ma	부들부들
부디	ma	부디
부랴 부랴	ma	부랴부랴
부랴부랴	ma	부랴부랴
부러	ma	부러
부르르	ma	부르르
부르릉	ma	부르릉
부르릉 부르릉	ma	부르릉부르릉
부르릉부르릉	ma	부르릉부르릉
부릉 부릉	ma	부릉부릉
부릉부릉	ma	부릉부릉
부리 부리	ma	부리부리
부리나케	ma	부리나케
부리부리	ma	부리부리
부붕	ma	부붕
부스럭	ma	부스럭
부스럭 부스럭	ma	부스럭부스럭
부스럭부스럭	ma	부스럭부스럭
부스스	ma	부스스
부슬 부슬	ma	부슬부슬
부슬부슬	ma	부슬부슬
부시시	ma	부시시
부얼 부얼	ma	부얼부얼
부얼부얼	ma	부얼부얼
부욱	ma	부욱
부웅	ma	부웅
부지런히	ma	부지런히
부질없이	ma	부질없이
부쩍	ma	부쩍
부쩍 부쩍	ma	부쩍부쩍
부쩍부쩍	ma	부쩍부쩍
북북	ma	북북
북작	ma	북작
분명이	ma	분명이
분명히	ma	분명히
분수껏	ma	분수껏
분연히	ma	분연히
분주히	ma	분주히
불그락 푸르락	ma	불그락푸르락
불그락푸르락	ma	불그락푸르락
불끈	ma	불끈
불끈 불끈	ma	불끈불끈
불끈불끈	ma	불끈불끈
불뚝	ma	불뚝
불룩	ma	불룩
불쌍히	ma	불쌍히
불쑥	ma	불쑥
불쑥 불쑥	ma	불쑥불쑥
불쑥불쑥	ma	불쑥불쑥
불안스레	ma	불안스레
불행히	ma	불행히
불현듯	ma	불현듯
붉으락 푸르락	ma	붉으락푸르락
붉으락푸르락	ma	붉으락푸르락
붕	ma	붕
붕붕	ma	붕붕
붕붕붕	ma	붕붕붕
비교적	ma	비교적
비로서	ma	비로서
비로소	ma	비로소
비록	ma	비록
비밀히	ma	비밀히
비스듬히	ma	비스듬히
비슷이	ma	비슷이
비슷히	ma	비슷히
비실비실	ma	비실비실
비죽 비죽	ma	비죽비죽
비죽비죽	ma	비죽비죽
비죽이	ma	비죽이
비쩍	ma	비쩍
비틀	ma	비틀
빈둥 빈둥	ma	빈둥빈둥
빈둥빈둥	ma	빈둥빈둥
빈들 빈들	ma	빈들빈들
빈들빈들	ma	빈들빈들
빈번히	ma	빈번히
빈틈 없이	ma	빈틈없이
빈틈없이	ma	빈틈없이
빌빌	ma	빌빌
빙	ma	빙
빙그레	ma	빙그레
빙글	ma	빙글
빙글 빙글	ma	빙글빙글
빙글빙글	ma	빙글빙글
빙긋	ma	빙긋
빙긋이	ma	빙긋이
빙빙	ma	빙빙
빠듯이	ma	빠듯이
빠딱 빠딱	ma	빠딱빠딱
빠딱빠딱	ma	빠딱빠딱
빠짐 없이	ma	빠짐없이
빠짐없이	ma	빠짐없이
빤지르르	ma	빤지르르
빤질 빤질	ma	빤질빤질
빤질빤질	ma	빤질빤질
빤짝	ma	빤짝
빤히	ma	빤히
빨딱	ma	빨딱
빨리	ma	빨리
빨리 빨리	ma	빨리빨리
빨리빨리	ma	빨리빨리
빳빳이	ma	빳빳이
빼곡	ma	빼곡
빼곡히	ma	빼곡히
빼꼼	ma	빼꼼
빼꼼이	ma	빼꼼이
빼쭉	ma	빼쭉
빽빽이	ma	빽빽이
빽빽히	ma	빽빽히
뻑	ma	뻑
뻔쩍	ma	뻔쩍
뻔쩍 뻔쩍	ma	뻔쩍뻔쩍
뻔쩍뻔쩍	ma	뻔쩍뻔쩍
뻔히	ma	뻔히
뻘뻘	ma	뻘뻘
뻣뻣이	ma	뻣뻣이
뻥뻥	ma	뻥뻥
뽀도독	ma	뽀도독
뽀옹	ma	뽀옹
뽀짝 뽀짝	ma	뽀짝뽀짝
뽀짝뽀짝	ma	뽀짝뽀짝
뽈뽈	ma	뽈뽈
뽕뽕	ma	뽕뽕
뾰루퉁	ma	뾰루퉁
뾰족	ma	뾰족
뾰족이	ma	뾰족이
뾰죽	ma	뾰죽
뿅	ma	뿅
뿌적 뿌적	ma	뿌적뿌적
뿌적뿌적	ma	뿌적뿌적
뿔뿔이	ma	뿔뿔이
뿡뿡	ma	뿡뿡
삐	ma	삐
삐걱	ma	삐걱
삐삐삑	ma	삐삐삑
삐죽	ma	삐죽
삐죽 삐죽	ma	삐죽삐죽
삐죽삐죽	ma	삐죽삐죽
삐죽이	ma	삐죽이
삐쩍	ma	삐쩍
삐쭉	ma	삐쭉
삑	ma	삑
사각 사각	ma	사각사각
사각사각	ma	사각사각
사그락	ma	사그락
사르르	ma	사르르
사뭇	ma	사뭇
사뿐사뿐	ma	사뿐사뿐
사뿐이	ma	사뿐이
사뿐히	ma	사뿐히
사사건건	ma	사사건건
사정없이	ma	사정없이
산산이	ma	산산이
살그머니	ma	살그머니
살금 살금	ma	살금살금
살금살금	ma	살금살금
살뜰히	ma	살뜰히
살랑	ma	살랑
살래 살래	ma	살래살래
살래살래	ma	살래살래
살레 살레	ma	살레살레
살레살레	ma	살레살레
살며시	ma	살며시
살살	ma	살살
살작	ma	살작
살짝	ma	살짝
살짝 살짝	ma	살짝살짝
살짝살짝	ma	살짝살짝
살포시	ma	살포시
살풋	ma	살풋
삼가	ma	삼가
상관 없이	ma	상관없이
상관없이	ma	상관없이
상당히	ma	상당히
상세히	ma	상세히
샅샅이	ma	샅샅이
새로	ma	새로
새로이	ma	새로이
새루	ma	새루
새삼	ma	새삼
새삼스러이	ma	새삼스러이
새삼스레	ma	새삼스레
샐쭉	ma	샐쭉
생게망게	ma	생게망게
생생히	ma	생생히
생으로	ma	생으로
생판	ma	생판
서로	ma	서로
서로 서로	ma	서로서로
서로서로	ma	서로서로
서루	ma	서루
서서히	ma	서서히
서슴 없이	ma	서슴없이
서슴없이	ma	서슴없이
선뜻	ma	선뜻
선뜻 선뜻	ma	선뜻선뜻
선뜻선뜻	ma	선뜻선뜻
선명히	ma	선명히
선선히	ma	선선히
선연히	ma	선연히
선히	ma	선히
섣불리	ma	섣불리
설레 설레	ma	설레설레
설레설레	ma	설레설레
설령	ma	설령
설마	ma	설마
설사	ma	설사
설설	ma	설설
설핏	ma	설핏
설혹	ma	설혹
섬뜩	ma	섬뜩
섬세히	ma	섬세히
섬찟	ma	섬찟
섬찢	ma	섬찢
성급히	ma	성급히
성대히	ma	성대히
성실히	ma	성실히
성심껏	ma	성심껏
성의껏	ma	성의껏
성큼	ma	성큼
성큼 성큼	ma	성큼성큼
성큼성큼	ma	성큼성큼
세밀히	ma	세밀히
소곤 소곤	ma	소곤소곤
소곤소곤	ma	소곤소곤
소롯이	ma	소롯이
소리 소리	ma	소리소리
소리소리	ma	소리소리
소복이	ma	소복이
소복히	ma	소복히
소상히	ma	소상히
소신껏	ma	소신껏
소위	ma	소위
소중히	ma	소중히
소홀히	ma	소홀히
속속	ma	속속
속속들이	ma	속속들이
속절 없이	ma	속절없이
속절없이	ma	속절없이
속히	ma	속히
손수	ma	손수
솔솔	ma	솔솔
솔직이	ma	솔직이
솔직히	ma	솔직히
송글 송글	ma	송글송글
송글송글	ma	송글송글
송두리 채	ma	송두리채
송두리채	ma	송두리채
송이 송이	ma	송이송이
송이송이	ma	송이송이
수굿이	ma	수굿이
수근 수근	ma	수근수근
수근수근	ma	수근수근
수런 수런	ma	수런수런
수런수런	ma	수런수런
수북이	ma	수북이
수북히	ma	수북히
수시로	ma	수시로
수없이	ma	수없이
순순히	ma	순순히
순전히	ma	순전히
술술	ma	술술
숨김없이	ma	숨김없이
숫제	ma	숫제
숭숭	ma	숭숭
쉬	ma	쉬
쉬엄 쉬엄	ma	쉬엄쉬엄
쉬엄쉬엄	ma	쉬엄쉬엄
쉬이	ma	쉬이
쉭쉭	ma	쉭쉭
쉽사리	ma	쉽사리
스르르	ma	스르르
스리 살짝	ma	스리살짝
스리살짝	ma	스리살짝
스멀 스멀	ma	스멀스멀
스멀스멀	ma	스멀스멀
스물 스물	ma	스물스물
스물스물	ma	스물스물
스스럼 없이	ma	스스럼없이
스스럼없이	ma	스스럼없이
스스로	ma	스스로
슬그머니	ma	슬그머니
슬근 슬근	ma	슬근슬근
슬근슬근	ma	슬근슬근
슬금 슬금	ma	슬금슬금
슬금슬금	ma	슬금슬금
슬며시	ma	슬며시
슬몃	ma	슬몃
슬슬	ma	슬슬
슬쩍	ma	슬쩍
슬쩍 슬쩍	ma	슬쩍슬쩍
슬쩍슬쩍	ma	슬쩍슬쩍
슬피	ma	슬피
시급히	ma	시급히
시끌 버끌	ma	시끌버끌
시끌 벅적	ma	시끌벅적
시끌 법석	ma	시끌법석
시끌버끌	ma	시끌버끌
시끌벅적	ma	시끌벅적
시끌법석	ma	시끌법석
시나브로	ma	시나브로
시들시들	ma	시들시들
시름시름	ma	시름시름
시방	ma	시방
시시 콜콜	ma	시시콜콜
시시콜콜	ma	시시콜콜
시원스레	ma	시원스레
시원스리	ma	시원스리
시원시원	ma	시원시원
시원히	ma	시원히
신랄히	ma	신랄히
신속히	ma	신속히
신중히	ma	신중히
신통스레	ma	신통스레
실로	ma	실로
실루	ma	실루
실실	ma	실실
실없이	ma	실없이
실은	ma	실은
실제로	ma	실제로
실지로	ma	실지로
실컨	ma	실컨
실컷	ma	실컷
실히	ma	실히
심각히	ma	심각히
심지어	ma	심지어
심히	ma	심히
십분	ma	십분
싱글 벙글	ma	싱글벙글
싱글 싱글	ma	싱글싱글
싱글벙글	ma	싱글벙글
싱글싱글	ma	싱글싱글
싱긋	ma	싱긋
싹	ma	싹
싹둑	ma	싹둑
싹뚝	ma	싹뚝
싹싹	ma	싹싹
쌍쌍이	ma	쌍쌍이
쌔근 쌔근	ma	쌔근쌔근
쌔근쌔근	ma	쌔근쌔근
쌕쌕	ma	쌕쌕
쌩	ma	쌩
쌩쌩	ma	쌩쌩
썩	ma	썩
쏘옥	ma	쏘옥
쏙	ma	쏙
쏜살같이	ma	쏜살같이
쏴아	ma	쏴아
쑤욱	ma	쑤욱
쑥	ma	쑥
쑥쑥	ma	쑥쑥
쓰쓰쓰	ma	쓰쓰쓰
쓰윽	ma	쓰윽
쓱	ma	쓱
쓱싹 쓱싹	ma	쓱싹쓱싹
쓱싹쓱싹	ma	쓱싹쓱싹
쓱쓱	ma	쓱쓱
쓸데없이	ma	쓸데없이
쓸쓸히	ma	쓸쓸히
씁쓰레	ma	씁쓰레
씨엉 씨엉	ma	씨엉씨엉
씨엉씨엉	ma	씨엉씨엉
씨익	ma	씨익
씩	ma	씩
씽긋	ma	씽긋
씽씽	ma	씽씽
아기자기	ma	아기자기
아낌없이	ma	아낌없이
아니	ma	아니
아니나 다를까	ma	아니나다를까
아니나다를까	ma	아니나다를까
아득히	ma	아득히
아등바등	ma	아등바등
아랑곳 없이	ma	아랑곳없이
아랑곳없이	ma	아랑곳없이
아련히	ma	아련히
아른 아른	ma	아른아른
아른아른	ma	아른아른
아름 아름	ma	아름아름
아름아름	ma	아름아름
아마	ma	아마
아마도	ma	아마도
아무 쪼록	ma	아무쪼록
아무래도	ma	아무래도
아무래두	ma	아무래두
아무리	ma	아무리
아무쪼록	ma	아무쪼록
아무튼	ma	아무튼
아물 아물	ma	아물아물
아물아물	ma	아물아물
아뭏든	ma	아뭏든
아삭 아삭	ma	아삭아삭
아삭아삭	ma	아삭아삭
아스 라이	ma	아스라이
아스라이	ma	아스라이
아스라히	ma	아스라히
아슬아슬	ma	아슬아슬
아슴 아슴	ma	아슴아슴
아슴아슴	ma	아슴아슴
아앙 아앙	ma	아앙아앙
아앙아앙	ma	아앙아앙
아연	ma	아연
아예	ma	아예
아옹다옹	ma	아옹다옹
아울러	ma	아울러
아웅	ma	아웅
아웅다웅	ma	아웅다웅
아주	ma	아주
아직	ma	아직
아직껏	ma	아직껏
악착 같이	ma	악착같이
악착같이	ma	악착같이
안녕히	ma	안녕히
안절부절	ma	안절부절
안타까이	ma	안타까이
알드리	ma	알드리
알뜰히	ma	알뜰히
알록달록	ma	알록달록
알쏭달쏭	ma	알쏭달쏭
알알이	ma	알알이
앗사리	ma	앗사리
앙	ma	앙
앞서	ma	앞서
앞앞이	ma	앞앞이
애달 캐달	ma	애달캐달
애달캐달	ma	애달캐달
애면 글면	ma	애면글면
애면글면	ma	애면글면
애석히	ma	애석히
애오라지	ma	애오라지
애지중지	ma	애지중지
애처로이	ma	애처로이
앵앵	ma	앵앵
야금 야금	ma	야금야금
야금야금	ma	야금야금
야코	ma	야코
약간	ma	약간
얌냠냠	ma	얌냠냠
얌전히	ma	얌전히
양심껏	ma	양심껏
어김 없이	ma	어김없이
어김없이	ma	어김없이
어느덧	ma	어느덧
어느새	ma	어느새
어둑어둑	ma	어둑어둑
어떻든	ma	어떻든
어련히	ma	어련히
어렴풋이	ma	어렴풋이
어렵사리	ma	어렵사리
어릿 어릿	ma	어릿어릿
어릿어릿	ma	어릿어릿
어물 어물	ma	어물어물
어물어물	ma	어물어물
어물쩍	ma	어물쩍
어물쩡	ma	어물쩡
어서	ma	어서
어서 어서	ma	어서어서
어서어서	ma	어서어서
어설피	ma	어설피
어슴푸레	ma	어슴푸레
어슷 어슷	ma	어슷어슷
어슷어슷	ma	어슷어슷
어얘	ma	어얘
어언	ma	어언
어여삐	ma	어여삐
어엿이	ma	어엿이
어영부영	ma	어영부영
어제	ma	어제
어지간히	ma	어지간히
어지러이	ma	어지러이
어질어질	ma	어질어질
어째서	ma	어째서
어쨋든	ma	어쨋든
어쨌거나	ma	어쨌거나
어쨌든	ma	어쨌든
어쩌고 저쩌고	ma	어쩌고저쩌고
어쩌고저쩌고	ma	어쩌고저쩌고
어쩌구 저쩌구	ma	어쩌구저쩌구
어쩌구저쩌구	ma	어쩌구저쩌구
어쩌다	ma	어쩌다
어쩌다가	ma	어쩌다가
어쩌면	ma	어쩌면
어쩐지	ma	어쩐지
어쩜	ma	어쩜
어찌	ma	어찌
어찌 어찌	ma	어찌어찌
어찌나	ma	어찌나
어찌어찌	ma	어찌어찌
어찌저찌	ma	어찌저찌
어차피	ma	어차피
어흥	ma	어흥
억시	ma	억시
억지로	ma	억지로
억지루	ma	억지루
언뜻	ma	언뜻
언뜻 언뜻	ma	언뜻언뜻
언뜻언뜻	ma	언뜻언뜻
언매나	ma	언매나
언제	ma	언제
언제나	ma	언제나
언젠가	ma	언젠가
언필칭	ma	언필칭
얼근히	ma	얼근히
얼기 설기	ma	얼기설기
얼기설기	ma	얼기설기
얼렁	ma	얼렁
얼렁 뚱땅	ma	얼렁뚱땅
얼렁뚱땅	ma	얼렁뚱땅
얼룩 덜룩	ma	얼룩덜룩
얼룩 얼룩	ma	얼룩얼룩
얼룩덜룩	ma	얼룩덜룩
얼룩얼룩	ma	얼룩얼룩
얼른	ma	얼른
얼른 얼른	ma	얼른얼른
얼른얼른	ma	얼른얼른
얼마나	ma	얼마나
얼마큼	ma	얼마큼
얼매나	ma	얼매나
얼씬	ma	얼씬
얼추	ma	얼추
얼토당토	ma	얼토당토
얼핏	ma	얼핏
엄격히	ma	엄격히
엄밀히	ma	엄밀히
엄숙히	ma	엄숙히
엄연히	ma	엄연히
엄정히	ma	엄정히
엄중히	ma	엄중히
엄청	ma	엄청
엄히	ma	엄히
없이	ma	없이
엉거주춤	ma	엉거주춤
엉겁결에	ma	엉겁결에
엉금 엉금	ma	엉금엉금
엉금엉금	ma	엉금엉금
엉엉	ma	엉엉
엎치락 뒤치락	ma	엎치락뒤치락
엎치락뒤치락	ma	엎치락뒤치락
에취	ma	에취
엔간히	ma	엔간히
여간	ma	여간
여러 모로	ma	여러모로
여러모로	ma	여러모로
여름내	ma	여름내
여실히	ma	여실히
여엉	ma	여엉
여전히	ma	여전히
여지 없이	ma	여지없이
여지껏	ma	여지껏
여지없이	ma	여지없이
여직	ma	여직
여태	ma	여태
여태껏	ma	여태껏
여하간	ma	여하간
여하튼	ma	여하튼
여하히	ma	여하히
역력히	ma	역력히
역시	ma	역시
연거푸	ma	연거푸
연년이	ma	연년이
연면히	ma	연면히
연신	ma	연신
열렬히	ma	열렬히
열심히	ma	열심히
영구히	ma	영구히
영낙 없이	ma	영낙없이
영낙없이	ma	영낙없이
영락 없이	ma	영락없이
영락없이	ma	영락없이
영영	ma	영영
영원히	ma	영원히
예사 로이	ma	예사로이
예사로	ma	예사로
예사로이	ma	예사로이
예컨대	ma	예컨대
오구구	ma	오구구
오늘	ma	오늘
오다 가다	ma	오다가다
오다가다	ma	오다가다
오돌 도돌	ma	오돌도돌
오돌도돌	ma	오돌도돌
오들 오들	ma	오들오들
오들오들	ma	오들오들
오똑	ma	오똑
오뚝	ma	오뚝
오락 가락	ma	오락가락
오락가락	ma	오락가락
오래	ma	오래
오래 도록	ma	오래도록
오래 오래	ma	오래오래
오래도록	ma	오래도록
오래오래	ma	오래오래
오로지	ma	오로지
오롯이	ma	오롯이
오롱 조롱	ma	오롱조롱
오롱조롱	ma	오롱조롱
오르락 내리락	ma	오르락내리락
오르락내리락	ma	오르락내리락
오밀조밀	ma	오밀조밀
오손 도손	ma	오손도손
오손도손	ma	오손도손
오순 도순	ma	오순도순
오순도순	ma	오순도순
오싹	ma	오싹
오싹오싹	ma	오싹오싹
오죽	ma	오죽
오죽이나	ma	오죽이나
오직	ma	오직
오히려	ma	오히려
옥신 각신	ma	옥신각신
옥신각신	ma	옥신각신
온당히	ma	온당히
온데간 데없이	ma	온데간데없이
온데간데없이	ma	온데간데없이
온전히	ma	온전히
온통	ma	온통
온퉁	ma	온퉁
올망 졸망	ma	올망졸망
올망졸망	ma	올망졸망
올바로	ma	올바로
올올이	ma	올올이
옹기종기	ma	옹기종기
와글 와글	ma	와글와글
와글와글	ma	와글와글
와들와들	ma	와들와들
와락	ma	와락
와락 와락	ma	와락와락
와락와락	ma	와락와락
와르르	ma	와르르
와삭 와삭	ma	와삭와삭
와삭와삭	ma	와삭와삭
왁	ma	왁
왁자지껄	ma	왁자지껄
완강히	ma	완강히
완벽히	ma	완벽히
완연히	ma	완연히
완전히	ma	완전히
왈	ma	왈
왈그랑	ma	왈그랑
왈카닥	ma	왈카닥
왈칵	ma	왈칵
왕왕	ma	왕왕
왕창	ma	왕창
왜	ma	왜
왜냐면	ma	왜냐면
왜냐하면	ma	왜냐하면
왠지	ma	왠지
왱	ma	왱
외따로	ma	외따로
외려	ma	외려
외로	ma	외로
외로이	ma	외로이
요란스레	ma	요란스레
요령껏	ma	요령껏
요리 조리	ma	요리조리
요리조리	ma	요리조리
요컨대	ma	요컨대
요행히	ma	요행히
용감히	ma	용감히
우걱지걱	ma	우걱지걱
우굴우굴	ma	우굴우굴
우글우글	ma	우글우글
우두커니	ma	우두커니
우뚝	ma	우뚝
우뚝우뚝	ma	우뚝우뚝
우락부락	ma	우락부락
우루루	ma	우루루
우르르	ma	우르르
우묵	ma	우묵
우물 우물	ma	우물우물
우물 쭈물	ma	우물쭈물
우물우물	ma	우물우물
우물쩍	ma	우물쩍
우물쭈물	ma	우물쭈물
우부룩이	ma	우부룩이
우선	ma	우선
우수수	ma	우수수
우연히	ma	우연히
우예	ma	우예
우왕좌왕	ma	우왕좌왕
우우 우우	ma	우우우우
우우우우	ma	우우우우
우적 우적	ma	우적우적
우적우적	ma	우적우적
우중충	ma	우중충
우째	ma	우째
우쭐	ma	우쭐
우쭐 우쭐	ma	우쭐우쭐
우쭐우쭐	ma	우쭐우쭐
우툴두툴	ma	우툴두툴
욱	ma	욱
울고불고	ma	울고불고
울긋불긋	ma	울긋불긋
울울히	ma	울울히
울컥	ma	울컥
울퉁불퉁	ma	울퉁불퉁
움뿍	ma	움뿍
움썩 움썩	ma	움썩움썩
움썩움썩	ma	움썩움썩
움푹	ma	움푹
웅기 중기	ma	웅기중기
웅기중기	ma	웅기중기
웅얼 웅얼	ma	웅얼웅얼
웅얼웅얼	ma	웅얼웅얼
워낙	ma	워낙
워낙이	ma	워낙이
원껏	ma	원껏
원만히	ma	원만히
원체	ma	원체
원활히	ma	원활히
월등히	ma	월등히
월매나	ma	월매나
웬만큼	ma	웬만큼
웬지	ma	웬지
위위윙	ma	위위윙
위위투웅	ma	위위투웅
윙	ma	윙
유난히	ma	유난히
유달리	ma	유달리
유독	ma	유독
유별 시리	ma	유별시리
유별시리	ma	유별시리
유심히	ma	유심히
유유히	ma	유유히
으레	ma	으레
으레히	ma	으레히
으례	ma	으례
으례껏	ma	으례껏
으례히	ma	으례히
으르릉	ma	으르릉
으스스	ma	으스스
으쓱	ma	으쓱
으젓히	ma	으젓히
으흑	ma	으흑
윽	ma	윽
은근히	ma	은근히
은밀히	ma	은밀히
은은히	ma	은은히
음매	ma	음매
응당	ma	응당
의당	ma	의당
의례히	ma	의례히
의연히	ma	의연히
의외로	ma	의외로
이글 이글	ma	이글이글
이글이글	ma	이글이글
이나마	ma	이나마
이다지	ma	이다지
이대로	ma	이대로
이대루	ma	이대루
이따	ma	이따
이따가	ma	이따가
이따금	ma	이따금
이따금 씩	ma	이따금씩
이따금씩	ma	이따금씩
이래 저래	ma	이래저래
이래저래	ma	이래저래
이러다가	ma	이러다가
이러쿵	ma	이러쿵
이러쿵저러쿵	ma	이러쿵저러쿵
이럭 저럭	ma	이럭저럭
이럭저럭	ma	이럭저럭
이루	ma	이루
이른바	ma	이른바
이를테면	ma	이를테면
이리	ma	이리
이리 저리	ma	이리저리
이리 저리로	ma	이리저리로
이리로	ma	이리로
이리저리	ma	이리저리
이리저리로	ma	이리저리로
이리하여	ma	이리하여
이만	ma	이만
이만치	ma	이만치
이만큼	ma	이만큼
이미	ma	이미
이상스래	ma	이상스래
이상스레	ma	이상스레
이상히	ma	이상히
이어	ma	이어
이어서	ma	이어서
이왕	ma	이왕
이왕 이면	ma	이왕이면
이왕에	ma	이왕에
이왕이면	ma	이왕이면
이윽고	ma	이윽고
이윽히	ma	이윽히
이제	ma	이제
이제껏	ma	이제껏
이제사	ma	이제사
이제서야	ma	이제서야
이제야	ma	이제야
이토록	ma	이토록
익히	ma	익히
인제	ma	인제
일껏	ma	일껏
일렁 일렁	ma	일렁일렁
일렁일렁	ma	일렁일렁
일부러	ma	일부러
일생토록	ma	일생토록
일약	ma	일약
일일이	ma	일일이
일절	ma	일절
일제히	ma	일제히
일직이	ma	일직이
일찌감치	ma	일찌감치
일찌기	ma	일찌기
일찍	ma	일찍
일찍이	ma	일찍이
일찍히	ma	일찍히
일체	ma	일체
일층	ma	일층
입때껏	ma	입때껏
잉	ma	잉
잉잉	ma	잉잉
자고로	ma	자고로
자그마치	ma	자그마치
자그만치	ma	자그만치
자근 자근	ma	자근자근
자근자근	ma	자근자근
자꼬마	ma	자꼬마
자꾸	ma	자꾸
자꾸 자꾸	ma	자꾸자꾸
자꾸자꾸	ma	자꾸자꾸
자끈 자끈	ma	자끈자끈
자끈자끈	ma	자끈자끈
자랑스레	ma	자랑스레
자못	ma	자못
자박 자박	ma	자박자박
자박자박	ma	자박자박
자상히	ma	자상히
자세히	ma	자세히
자알	ma	자알
자연스레	ma	자연스레
자연히	ma	자연히
자유 로이	ma	자유로이
자유로이	ma	자유로이
자주	ma	자주
자칫	ma	자칫
잔뜩	ma	잔뜩
잔잔히	ma	잔잔히
잘	ma	잘
잘근 잘근	ma	잘근잘근
잘근잘근	ma	잘근잘근
잘록	ma	잘록
잘못	ma	잘못
잘쑥	ma	잘쑥
잠간	ma	잠간
잠깐	ma	잠깐
잠시	ma	잠시
잠자코	ma	잠자코
장차	ma	장차
장황히	ma	장황히
재간껏	ma	재간껏
재빨리	ma	재빨리
재삼	ma	재삼
재잘 재잘	ma	재잘재잘
재잘재잘	ma	재잘재잘
재주껏	ma	재주껏
재차	ma	재차
저러쿵	ma	저러쿵
저리로	ma	저리로
저릿저릿	ma	저릿저릿
저마다	ma	저마다
저만치	ma	저만치
저만큼	ma	저만큼
저벅 저벅	ma	저벅저벅
저벅저벅	ma	저벅저벅
저으기	ma	저으기
저절로	ma	저절로
저토록	ma	저토록
적당히	ma	적당히
적실히	ma	적실히
적어도	ma	적어도
적이	ma	적이
적잖이	ma	적잖이
적절히	ma	적절히
적지않이	ma	적지않이
전연	ma	전연
전혀	ma	전혀
절대	ma	절대
절대로	ma	절대로
절대루	ma	절대루
절레절레	ma	절레절레
절로	ma	절로
절실히	ma	절실히
절절이	ma	절절이
절절히	ma	절절히
점점	ma	점점
점점이	ma	점점이
점차	ma	점차
정녕	ma	정녕
정말	ma	정말
정말로	ma	정말로
정성껏	ma	정성껏
정성스레	ma	정성스레
정신 없이	ma	정신없이
정신없이	ma	정신없이
정정당당히	ma	정정당당히
정제히	ma	정제히
정중히	ma	정중히
정확히	ma	정확히
정히	ma	정히
제 아무리	ma	제아무리
제가끔	ma	제가끔
제각기	ma	제각기
제대로	ma	제대로
제대루	ma	제대루
제멋대로	ma	제멋대로
제멋대루	ma	제멋대루
제발	ma	제발
제법	ma	제법
제시딱	ma	제시딱
제아 무리	ma	제아무리
제아무리	ma	제아무리
제풀에	ma	제풀에
조각 조각	ma	조각조각
조각조각	ma	조각조각
조급히	ma	조급히
조마조마	ma	조마조마
조만간	ma	조만간
조붓이	ma	조붓이
조속히	ma	조속히
조심스레	ma	조심스레
조심조심	ma	조심조심
조용조용	ma	조용조용
조용히	ma	조용히
족히	ma	족히
졸락 졸락	ma	졸락졸락
졸락졸락	ma	졸락졸락
졸졸	ma	졸졸
졸졸졸	ma	졸졸졸
좀	ma	좀
좀처럼	ma	좀처럼
좀체	ma	좀체
좀체로	ma	좀체로
종래	ma	종래
종신토록	ma	종신토록
종일토록	ma	종일토록
종종	ma	종종
좌르르	ma	좌르르
좔좔	ma	좔좔
죄다	ma	죄다
주렁 주렁	ma	주렁주렁
주렁주렁	ma	주렁주렁
주로	ma	주로
주루룩	ma	주루룩
주르르	ma	주르르
주물쩍	ma	주물쩍
주삣	ma	주삣
주섬 주섬	ma	주섬주섬
주섬주섬	ma	주섬주섬
주욱	ma	주욱
주저 주저	ma	주저주저
주저주저	ma	주저주저
주절 주절	ma	주절주절
주절주절	ma	주절주절
주줄이	ma	주줄이
주춤	ma	주춤
주춤 주춤	ma	주춤주춤
주춤주춤	ma	주춤주춤
죽죽	ma	죽죽
줄곧	ma	줄곧
줄줄	ma	줄줄
줄줄이	ma	줄줄이
줄창	ma	줄창
중얼 중얼	ma	중얼중얼
중얼중얼	ma	중얼중얼
중히	ma	중히
즉	ma	즉
즉각	ma	즉각
즉시	ma	즉시
즐거이	ma	즐거이
지그시	ma	지그시
지극히	ma	지극히
지근지근	ma	지근지근
지금껏	ma	지금껏
지긋이	ma	지긋이
지독히	ma	지독히
지레	ma	지레
지지 영영	ma	지지영영
지지리	ma	지지리
지지영영	ma	지지영영
지풀에	ma	지풀에
진실로	ma	진실로
진작	ma	진작
진작에	ma	진작에
진즉	ma	진즉
진즉에	ma	진즉에
진탕	ma	진탕
질끈	ma	질끈
질질	ma	질질
질펀히	ma	질펀히
짐짓	ma	짐짓
집적집적	ma	집적집적
집집이	ma	집집이
징징	ma	징징
짜로	ma	짜로
짜악	ma	짜악
짜자작 짜자작	ma	짜자작짜자작
짜자작짜자작	ma	짜자작짜자작
짝짝	ma	짝짝
짝짝짝	ma	짝짝짝
짤래 짤래	ma	짤래짤래
짤래짤래	ma	짤래짤래
짤막짤막	ma	짤막짤막
짤짤	ma	짤짤
짬짬이	ma	짬짬이
짱	ma	짱
쨍	ma	쨍
쨍그랑	ma	쨍그랑
쩌렁 쩌렁	ma	쩌렁쩌렁
쩌렁쩌렁	ma	쩌렁쩌렁
쩍	ma	쩍
쩍쩍	ma	쩍쩍
쩔뚝 쩔뚝	ma	쩔뚝쩔뚝
쩔뚝쩔뚝	ma	쩔뚝쩔뚝
쩔쩔	ma	쩔쩔
쩝쩝	ma	쩝쩝
쩡쩡	ma	쩡쩡
쪼끔	ma	쪼끔
쪼르르	ma	쪼르르
쫄딱	ma	쫄딱
쫑긋	ma	쫑긋
쫙	ma	쫙
쫙쫙	ma	쫙쫙
쭈글	ma	쭈글
쭈글 쭈글	ma	쭈글쭈글
쭈글쭈글	ma	쭈글쭈글
쭈빗 쭈빗	ma	쭈빗쭈빗
쭈빗쭈빗	ma	쭈빗쭈빗
쭈뼛	ma	쭈뼛
쭉	ma	쭉
쭉쭉	ma	쭉쭉
쭐쭐	ma	쭐쭐
쯧	ma	쯧
쯧쯧	ma	쯧쯧
찌르르	ma	찌르르
찌르릉	ma	찌르릉
찌리링	ma	찌리링
찌릿 찌릿	ma	찌릿찌릿
찌릿찌릿	ma	찌릿찌릿
찌익 찌익	ma	찌익찌익
찌익찌익	ma	찌익찌익
찌찌	ma	찌찌
찍	ma	찍
찐득 찐득	ma	찐득찐득
찐득찐득	ma	찐득찐득
찔깃 찔깃	ma	찔깃찔깃
찔깃찔깃	ma	찔깃찔깃
찔끔	ma	찔끔
찔끔 찔끔	ma	찔끔찔끔
찔끔찔끔	ma	찔끔찔끔
찡	ma	찡
찡긋	ma	찡긋
차곡차곡	ma	차곡차곡
차근	ma	차근
차근차근	ma	차근차근
차근차근히	ma	차근차근히
차근히	ma	차근히
차라리	ma	차라리
차랑 차랑	ma	차랑차랑
차랑차랑	ma	차랑차랑
차례 차례	ma	차례차례
차례차례	ma	차례차례
차마	ma	차마
차분히	ma	차분히
차일피일	ma	차일피일
차차	ma	차차
차차로	ma	차차로
차츰	ma	차츰
차츰 차츰	ma	차츰차츰
차츰차츰	ma	차츰차츰
착	ma	착
착실히	ma	착실히
착착	ma	착착
찬찬히	ma	찬찬히
찰랑 찰랑	ma	찰랑찰랑
찰랑찰랑	ma	찰랑찰랑
찰싹	ma	찰싹
찰칵	ma	찰칵
찰칵 찰칵	ma	찰칵찰칵
찰칵찰칵	ma	찰칵찰칵
참	ma	참
참말로	ma	참말로
참으로	ma	참으로
창황히	ma	창황히
채	ma	채
처연히	ma	처연히
처절히	ma	처절히
처참히	ma	처참히
척	ma	척
척척	ma	척척
천천히	ma	천천히
철두철미	ma	철두철미
철렁	ma	철렁
철썩	ma	철썩
철썩 철썩	ma	철썩철썩
철썩철썩	ma	철썩철썩
철없이	ma	철없이
철저히	ma	철저히
철철	ma	철철
철커덕	ma	철커덕
첩첩	ma	첩첩
첩첩이	ma	첩첩이
초롱 초롱	ma	초롱초롱
초롱초롱	ma	초롱초롱
초연히	ma	초연히
초초히	ma	초초히
촉촉이	ma	촉촉이
촉촉히	ma	촉촉히
촌촌이	ma	촌촌이
촘촘히	ma	촘촘히
총총	ma	총총
총총히	ma	총총히
추줄 추줄	ma	추줄추줄
추줄추줄	ma	추줄추줄
축축이	ma	축축이
축축히	ma	축축히
출렁	ma	출렁
출렁 출렁	ma	출렁출렁
출렁출렁	ma	출렁출렁
충만히	ma	충만히
충분히	ma	충분히
충실히	ma	충실히
측은히	ma	측은히
층층이	ma	층층이
치렁치렁	ma	치렁치렁
치익	ma	치익
칙	ma	칙
친(親)히	ma	친(親)히
친밀히	ma	친밀히
친절히	ma	친절히
친친	ma	친친
친히	ma	친히
칭칭	ma	칭칭
카랑 카랑	ma	카랑카랑
카랑카랑	ma	카랑카랑
카악	ma	카악
카앙 카앙	ma	카앙카앙
카앙카앙	ma	카앙카앙
칵	ma	칵
캄캄히	ma	캄캄히
캭	ma	캭
켜켜로	ma	켜켜로
콕	ma	콕
콕콕	ma	콕콕
콕콕콕	ma	콕콕콕
콜록 콜록	ma	콜록콜록
콜록콜록	ma	콜록콜록
콩닥 콩닥	ma	콩닥콩닥
콩닥콩닥	ma	콩닥콩닥
콰다당	ma	콰다당
콱	ma	콱
콱콱	ma	콱콱
쾅	ma	쾅
쾅쾅	ma	쾅쾅
쾌히	ma	쾌히
쿠당탕	ma	쿠당탕
쿠쿠	ma	쿠쿠
쿡	ma	쿡
쿡쿡	ma	쿡쿡
쿨럭 쿨럭	ma	쿨럭쿨럭
쿨럭쿨럭	ma	쿨럭쿨럭
쿨룩 쿨룩	ma	쿨룩쿨룩
쿨룩쿨룩	ma	쿨룩쿨룩
쿨쿨	ma	쿨쿨
쿵	ma	쿵
쿵쾅 쿵쾅	ma	쿵쾅쿵쾅
쿵쾅쿵쾅	ma	쿵쾅쿵쾅
쿵쿵	ma	쿵쿵
크악	ma	크악
크으윽	ma	크으윽
큭	ma	큭
큼직큼직	ma	큼직큼직
킁킁	ma	킁킁
키득 키득	ma	키득키득
키득키득	ma	키득키득
타다닥	ma	타다닥
타닥닥	ma	타닥닥
탁	ma	탁
탁탁	ma	탁탁
탄탄히	ma	탄탄히
탐탐히	ma	탐탐히
탕탕	ma	탕탕
탕탕탕	ma	탕탕탕
태만히	ma	태만히
태연히	ma	태연히
태평스레	ma	태평스레
터덜 터덜	ma	터덜터덜
터덜터덜	ma	터덜터덜
터무니없이	ma	터무니없이
터억	ma	터억
턱없이	ma	턱없이
털거덕	ma	털거덕
털썩	ma	털썩
털커덩	ma	털커덩
텀벙 텀벙	ma	텀벙텀벙
텀벙텀벙	ma	텀벙텀벙
텅	ma	텅
텅텅	ma	텅텅
토실 토실	ma	토실토실
토실토실	ma	토실토실
톡	ma	톡
톡톡이	ma	톡톡이
톡톡히	ma	톡톡히
톨톨	ma	톨톨
통렬히	ma	통렬히
통절히	ma	통절히
통째	ma	통째
통통	ma	통통
투닥 투닥	ma	투닥투닥
투닥투닥	ma	투닥투닥
투덕 투덕	ma	투덕투덕
투덕투덕	ma	투덕투덕
투우웅	ma	투우웅
투웅	ma	투웅
툭	ma	툭
툭툭	ma	툭툭
툭하면	ma	툭하면
툴툴	ma	툴툴
퉁명스레	ma	퉁명스레
퉁퉁	ma	퉁퉁
퉤	ma	퉤
특별히	ma	특별히
특히	ma	특히
튼튼히	ma	튼튼히
틀림 없이	ma	틀림없이
틀림없이	ma	틀림없이
틈틈이	ma	틈틈이
틈틈히	ma	틈틈히
티격태격	ma	티격태격
파르르	ma	파르르
파릇 파릇	ma	파릇파릇
파릇파릇	ma	파릇파릇
팍	ma	팍
팔딱	ma	팔딱
팔딱 팔딱	ma	팔딱팔딱
팔딱팔딱	ma	팔딱팔딱
팔랑 팔랑	ma	팔랑팔랑
팔랑팔랑	ma	팔랑팔랑
팽그르르	ma	팽그르르
팽팽히	ma	팽팽히
퍼드덕 퍼드덕	ma	퍼드덕퍼드덕
퍼드덕퍼드덕	ma	퍼드덕퍼드덕
퍼뜩	ma	퍼뜩
퍼석	ma	퍼석
퍽	ma	퍽
퍽퍽	ma	퍽퍽
펄럭	ma	펄럭
펄럭 펄럭	ma	펄럭펄럭
펄럭펄럭	ma	펄럭펄럭
펄쩍	ma	펄쩍
펄펄	ma	펄펄
펑	ma	펑
펑펑	ma	펑펑
편안히	ma	편안히
편히	ma	편히
평생토록	ma	평생토록
평안히	ma	평안히
포근포근	ma	포근포근
포동포동	ma	포동포동
폭삭	ma	폭삭
폭신폭신	ma	폭신폭신
폭싹	ma	폭싹
폴짝 폴짝	ma	폴짝폴짝
폴짝폴짝	ma	폴짝폴짝
퐁당	ma	퐁당
표연히	ma	표연히
표표히	ma	표표히
푸그락	ma	푸그락
푸드득	ma	푸드득
푸드득 푸드득	ma	푸드득푸드득
푸드득푸드득	ma	푸드득푸드득
푸드윽	ma	푸드윽
푸득 푸득	ma	푸득푸득
푸득푸득	ma	푸득푸득
푸들 푸들	ma	푸들푸들
푸들푸들	ma	푸들푸들
푸릇 푸릇	ma	푸릇푸릇
푸릇푸릇	ma	푸릇푸릇
푸석 푸석	ma	푸석푸석
푸석푸석	ma	푸석푸석
푸짐히	ma	푸짐히
푹	ma	푹
푹푹	ma	푹푹
푼푼이	ma	푼푼이
풀썩	ma	풀썩
풀풀	ma	풀풀
풍부히	ma	풍부히
풍족히	ma	풍족히
피둥 피둥	ma	피둥피둥
피둥피둥	ma	피둥피둥
피식	ma	피식
피식 피식	ma	피식피식
피식피식	ma	피식피식
픽	ma	픽
픽픽	ma	픽픽
필경	ma	필경
필시	ma	필시
필히	ma	필히
핑	ma	핑
핑그르	ma	핑그르
하기는	ma	하기는
하기사	ma	하기사
하기야	ma	하기야
하긴	ma	하긴
하늘 하늘	ma	하늘하늘
하늘하늘	ma	하늘하늘
하다못해	ma	하다못해
하닥 하닥	ma	하닥하닥
하닥하닥	ma	하닥하닥
하도	ma	하도
하두	ma	하두
하루 빨리	ma	하루빨리
하루바삐	ma	하루바삐
하루빨리	ma	하루빨리
하루속히	ma	하루속히
하르르	ma	하르르
하릴없이	ma	하릴없이
하마터면	ma	하마터면
하물며	ma	하물며
하여간	ma	하여간
하여금	ma	하여금
하여튼	ma	하여튼
하염없이	ma	하염없이
하옇든	ma	하옇든
하오나	ma	하오나
하잘것 없이	ma	하잘것없이
하잘것없이	ma	하잘것없이
하지만	ma	하지만
하필	ma	하필
하필이면	ma	하필이면
하하 하하	ma	하하하하
하하하	ma	하하하
하하하하	ma	하하하하
한가득	ma	한가득
한가로이	ma	한가로이
한가히	ma	한가히
한갓	ma	한갓
한결	ma	한결
한결같이	ma	한결같이
한꺼번에	ma	한꺼번에
한껏	ma	한껏
한낱	ma	한낱
한데	ma	한데
한들 한들	ma	한들한들
한들한들	ma	한들한들
한바탕	ma	한바탕
한발	ma	한발
한사코	ma	한사코
한시바삐	ma	한시바삐
한없이	ma	한없이
한층	ma	한층
한평생	ma	한평생
함께	ma	함께
함부로	ma	함부로
함빡	ma	함빡
항상	ma	항상
항용	ma	항용
해해	ma	해해
행여	ma	행여
행여나	ma	행여나
허겁 지겁	ma	허겁지겁
허겁지겁	ma	허겁지겁
허기야	ma	허기야
허나	ma	허나
허다히	ma	허다히
허덕 허덕	ma	허덕허덕
허덕허덕	ma	허덕허덕
허둥지둥	ma	허둥지둥
허무히	ma	허무히
허술히	ma	허술히
허지만	ma	허지만
허허허	ma	허허허
헉	ma	헉
헉헉	ma	헉헉
헌데	ma	헌데
헐레 벌떡	ma	헐레벌떡
헐레벌떡	ma	헐레벌떡
헛되이	ma	헛되이
헤헤	ma	헤헤
헬레레	ma	헬레레
현격히	ma	현격히
현저히	ma	현저히
호락호락	ma	호락호락
호젓이	ma	호젓이
혹	ma	혹
혹간	ma	혹간
혹시	ma	혹시
혹시나	ma	혹시나
혹은	ma	혹은
홀딱	ma	홀딱
홀랑	ma	홀랑
홀로	ma	홀로
홀연	ma	홀연
홀연히	ma	홀연히
홀짝	ma	홀짝
화급히	ma	화급히
화끈	ma	화끈
화끈 화끈	ma	화끈화끈
화끈화끈	ma	화끈화끈
화들짝	ma	화들짝
화르르	ma	화르르
확	ma	확
확고히	ma	확고히
확실히	ma	확실히
확연히	ma	확연히
확확	ma	확확
환히	ma	환히
활발히	ma	활발히
활작	ma	활작
활짝	ma	활짝
활활	ma	활활
홧홧	ma	홧홧
황급히	ma	황급히
황망히	ma	황망히
황황히	ma	황황히
홱	ma	홱
후끈	ma	후끈
후다닥	ma	후다닥
후닥닥	ma	후닥닥
후두둑	ma	후두둑
후둑 후둑	ma	후둑후둑
후둑후둑	ma	후둑후둑
후들 후들	ma	후들후들
후들후들	ma	후들후들
후딱	ma	후딱
후련히	ma	후련히
후루룩	ma	후루룩
후루룩 후루룩	ma	후루룩후루룩
후루룩후루룩	ma	후루룩후루룩
후후	ma	후후
후히	ma	후히
훅	ma	훅
훌렁	ma	훌렁
훌륭히	ma	훌륭히
훌쩍	ma	훌쩍
훌쩍훌쩍	ma	훌쩍훌쩍
훌찌럭훌찌럭	ma	훌찌럭훌찌럭
훌훌	ma	훌훌
훌훌히	ma	훌훌히
훗훗	ma	훗훗
훠얼씬	ma	훠얼씬
훤이	ma	훤이
훤히	ma	훤히
훨씬	ma	훨씬
훨훨	ma	훨훨
휘딱	ma	휘딱
휘뚜루	ma	휘뚜루
휘뚜루 마뚜루	ma	휘뚜루마뚜루
휘뚜루마뚜루	ma	휘뚜루마뚜루
휘영청	ma	휘영청
휘익	ma	휘익
휘적 휘적	ma	휘적휘적
휘적휘적	ma	휘적휘적
휘청	ma	휘청
휙	ma	휙
휙휙	ma	휙휙
휠씬	ma	휠씬
휭	ma	휭
휭하니	ma	휭하니
휭휭	ma	휭휭
흐르르	ma	흐르르
흐물 흐물	ma	흐물흐물
흐물흐물	ma	흐물흐물
흐지부지	ma	흐지부지
흔들흔들	ma	흔들흔들
흔연히	ma	흔연히
흔전만전	ma	흔전만전
흔쾌히	ma	흔쾌히
흔히	ma	흔히
흘깃	ma	흘깃
흘낏	ma	흘낏
흠뻑	ma	흠뻑
흠칠	ma	흠칠
흠칫	ma	흠칫
흠흠	ma	흠흠
흡사	ma	흡사
흥건히	ma	흥건히
흥얼 흥얼	ma	흥얼흥얼
흥얼흥얼	ma	흥얼흥얼
흥청망청	ma	흥청망청
희끗희끗	ma	희끗희끗
희뜩	ma	희뜩
히죽	ma	히죽
히죽 히죽	ma	히죽히죽
히죽이	ma	히죽이
히죽히죽	ma	히죽히죽
히쭉	ma	히쭉
힐긋	ma	힐긋
힐끔	ma	힐끔
힐끔 힐끔	ma	힐끔힐끔
힐끔힐끔	ma	힐끔힐끔
힐끗	ma	힐끗
힐끗 힐끗	ma	힐끗힐끗
힐끗힐끗	ma	힐끗힐끗
힘껏	ma	힘껏
힘없이	ma	힘없이
힛힛힛	ma	힛힛힛
힝	ma	힝
가진	mm	가진
갖은	mm	갖은
고얀	mm	고얀
그까짓	mm	그까짓
그깟	mm	그깟
그따위	mm	그따위
그딴	mm	그딴
그런	mm	그런
그런저런	mm	그런저런
긴긴	mm	긴긴
까짓	mm	까짓
넉	mm	넉
다른	mm	다른
댓	mm	댓
두서너	mm	두서너
두세	mm	두세
두어	mm	두어
뒷	mm	뒷
몇	mm	몇
몇몇	mm	몇몇
모든	mm	모든
몹쓸	mm	몹쓸
무슨	mm	무슨
뭔	mm	뭔
벼라별	mm	벼라별
별별	mm	별별
별의별	mm	별의별
서너	mm	서너
스무	mm	스무
아랫	mm	아랫
아무	mm	아무
아무런	mm	아무런
양대	mm	양대
어느	mm	어느
어떤	mm	어떤
어인	mm	어인
여나믄	mm	여나믄
여느	mm	여느
여늬	mm	여늬
여러	mm	여러
오랜	mm	오랜
오랫	mm	오랫
오른	mm	오른
오오랜	mm	오오랜
온갖	mm	온갖
외딴	mm	외딴
왼	mm	왼
요런	mm	요런
웬	mm	웬
윗	mm	윗
이까짓	mm	이까짓
이런	mm	이런
이런저런	mm	이런저런
장장	mm	장장
저런	mm	저런
첫	mm	첫
한두	mm	한두
허튼	mm	허튼
가량	nb	가량
개대	nb	개대
개사	nb	개사
개소	nb	개소
개월	nb	개월
갤런	nb	갤런
겨를	nb	겨를
겸	nb	겸
광년	nb	광년
군데	nb	군데
그램	nb	그램
그루	nb	그루
기가	nb	기가
기가바이트	nb	기가바이트
꺼	nb	꺼
꺼리	nb	꺼리
나름	nb	나름
나위	nb	나위
남짓	nb	남짓
냥	nb	냥
년대	nb	년대
년차	nb	년차
달라	nb	달라
대루	nb	대루
데	nb	데
데시벨	nb	데시벨
돈쭝	nb	돈쭝
드라크마	nb	드라크마
듯	nb	듯
듯이	nb	듯이
등성	nb	등성
등지	nb	등지
따우	nb	따우
따위	nb	따위
딴	nb	딴
루피	nb	루피
루피아	nb	루피아
리터	nb	리터
마일	nb	마일
마장	nb	마장
마지기	nb	마지기
만치	nb	만치
만큼	nb	만큼
메가바이트	nb	메가바이트
뭇	nb	뭇
밀리	nb	밀리
발짝	nb	발짝
뿐	nb	뿐
삭	nb	삭
센티미터	nb	센티미터
어치	nb	어치
에르	nb	에르
에이커	nb	에이커
엥	nb	엥
옹	nb	옹
움큼	nb	움큼
웅큼	nb	웅큼
원권	nb	원권
인승	nb	인승
절지	nb	절지
족족	nb	족족
즈음	nb	즈음
즘	nb	즘
쯤	nb	쯤
켠	nb	켠
켤레	nb	켤레
큐핏	nb	큐핏
크로나	nb	크로나
킬로그램	nb	킬로그램
킬로미터	nb	킬로미터
킬로바이트	nb	킬로바이트
타스	nb	타스
톨	nb	톨
페소	nb	페소
평방미터	nb	평방미터
할	nb	할
해리	nb	해리
홉	nb	홉
가능	nc	가능
가당	nc	가당
가련	nc	가련
가무잡잡	nc	가무잡잡
가뿐	nc	가뿐
가열	nc	가열
가지런	nc	가지런
가혹	nc	가혹
각다분	nc	각다분
각박	nc	각박
각별	nc	각별
간결	nc	간결
간곡	nc	간곡
간구	nc	간구
간단	nc	간단
간략	nc	간략
간명	nc	간명
간소	nc	간소
간악	nc	간악
간절	nc	간절
간편	nc	간편
갑갑	nc	갑갑
강건	nc	강건
강경	nc	강경
강고	nc	강고
강대	nc	강대
강력	nc	강력
강렬	nc	강렬
강성	nc	강성
강열	nc	강열
강직	nc	강직
개운	nc	개운
갸륵	nc	갸륵
갸름	nc	갸름
거나	nc	거나
거대	nc	거대
거뜬	nc	거뜬
거룩	nc	거룩
거무스름	nc	거무스름
거무죽죽	nc	거무죽죽
거무튀튀	nc	거무튀튀
거북	nc	거북
거창	nc	거창
건실	nc	건실
건장	nc	건장
건전	nc	건전
걸직	nc	걸직
걸쭉	nc	걸쭉
격렬	nc	격렬
격심	nc	격심
견결	nc	견결
견고	nc	견고
견실	nc	견실
결연	nc	결연
경건	nc	경건
경미	nc	경미
경박	nc	경박
경직	nc	경직
경쾌	nc	경쾌
고고	nc	고고
고귀	nc	고귀
고단	nc	고단
고루	nc	고루
고리타분	nc	고리타분
고만고만	nc	고만고만
고매	nc	고매
고상	nc	고상
고소	nc	고소
고약	nc	고약
고이	nc	고이
고즈넉	nc	고즈넉
고지식	nc	고지식
곡진	nc	곡진
곤고	nc	곤고
곤핍	nc	곤핍
골똘	nc	골똘
곱살	nc	곱살
공고	nc	공고
공공연	nc	공공연
공교	nc	공교
공명	nc	공명
공손	nc	공손
공순	nc	공순
공연	nc	공연
공허	nc	공허
과감	nc	과감
과격	nc	과격
과대	nc	과대
과분	nc	과분
과중	nc	과중
관대	nc	관대
관후	nc	관후
괄괄	nc	괄괄
광막	nc	광막
광범	nc	광범
광장	nc	광장
광활	nc	광활
괘씸	nc	괘씸
괴괴	nc	괴괴
괴상	nc	괴상
괴상망칙	nc	괴상망칙
괴상야릇	nc	괴상야릇
괴이	nc	괴이
괴팍	nc	괴팍
굉장	nc	굉장
교묘	nc	교묘
교활	nc	교활
구가	nc	구가
구구	nc	구구
구부정	nc	구부정
구수	nc	구수
구저분	nc	구저분
구차	nc	구차
구태의연	nc	구태의연
군색	nc	군색
굳건	nc	굳건
굵직	nc	굵직
굵직굵직	nc	굵직굵직
궁금	nc	궁금
궁벽	nc	궁벽
귀중	nc	귀중
그러	nc	그러
그러저러	nc	그러저러
그럴싸	nc	그럴싸
그만	nc	그만
그만그만	nc	그만그만
그윽	nc	그윽
극명	nc	극명
극심	nc	극심
극진	nc	극진
근사	nc	근사
근소	nc	근소
근엄	nc	근엄
급격	nc	급격
급급	nc	급급
기괴	nc	기괴
기기묘묘	nc	기기묘묘
기묘	nc	기묘
기민	nc	기민
기박	nc	기박
기발	nc	기발
기세등등	nc	기세등등
기이	nc	기이
기특	nc	기특
긴가민가	nc	긴가민가
긴밀	nc	긴밀
긴요	nc	긴요
길쭉	nc	길쭉
깊숙	nc	깊숙
까마득	nc	까마득
까마아득	nc	까마아득
까무잡잡	nc	까무잡잡
까칠	nc	까칠
깍듯	nc	깍듯
깐깐	nc	깐깐
깔깔	nc	깔깔
깔끄레	nc	깔끄레
깔끔	nc	깔끔
깜깜	nc	깜깜
깜찍	nc	깜찍
깡똥	nc	깡똥
깨끗	nc	깨끗
꺼림칙	nc	꺼림칙
꺼벙	nc	꺼벙
꺼칠	nc	꺼칠
껑충	nc	껑충
께름칙	nc	께름칙
꼼꼼	nc	꼼꼼
꽁알	nc	꽁알
꾀죄죄	nc	꾀죄죄
꾸부정	nc	꾸부정
꾸준	nc	꾸준
꿋꿋	nc	꿋꿋
끈끈	nc	끈끈
끈적	nc	끈적
끔직	nc	끔직
끔찍	nc	끔찍
나른	nc	나른
나약	nc	나약
나지막	nc	나지막
나직	nc	나직
난감	nc	난감
난삽	nc	난삽
난잡	nc	난잡
난처	nc	난처
난해	nc	난해
날렵	nc	날렵
날씬	nc	날씬
납작	nc	납작
낭랑	nc	낭랑
낭자	nc	낭자
내로라	nc	내로라
냉랭	nc	냉랭
냉엄	nc	냉엄
냉철	nc	냉철
냉혹	nc	냉혹
너끈	nc	너끈
너저분	nc	너저분
너절	nc	너절
넉넉	nc	넉넉
널죽	nc	널죽
널찍	nc	널찍
넓적	nc	넓적
넘넘	nc	넘넘
노곤	nc	노곤
노골	nc	노골
노련	nc	노련
노르끄레	nc	노르끄레
노리끼	nc	노리끼
녹녹	nc	녹녹
녹록	nc	녹록
논	nc	논
농후	nc	농후
누리끼리	nc	누리끼리
누추	nc	누추
눅눅	nc	눅눅
눅신	nc	눅신
눅진	nc	눅진
느긋	nc	느긋
느끼	nc	느끼
느슨	nc	느슨
느지막	nc	느지막
늘씬	nc	늘씬
늙수그레	nc	늙수그레
늠름	nc	늠름
능란	nc	능란
능숙	nc	능숙
능통	nc	능통
다각	nc	다각
다감	nc	다감
다급	nc	다급
다기	nc	다기
다난	nc	다난
다단	nc	다단
다분	nc	다분
다소곳	nc	다소곳
다양	nc	다양
다이내믹	nc	다이내믹
다재다능	nc	다재다능
다정	nc	다정
다정다감	nc	다정다감
다채	nc	다채
단단	nc	단단
단란	nc	단란
단순	nc	단순
단아	nc	단아
단정	nc	단정
단촐	nc	단촐
단출	nc	단출
단호	nc	단호
달짝지근	nc	달짝지근
달착지근	nc	달착지근
달콤	nc	달콤
달콤새콤	nc	달콤새콤
담담	nc	담담
담대	nc	담대
담백	nc	담백
답답	nc	답답
당	nc	당
당당	nc	당당
당돌	nc	당돌
당연	nc	당연
대견	nc	대견
대단	nc	대단
대담	nc	대담
대범	nc	대범
더부룩	nc	더부룩
덜큰	nc	덜큰
덤덤	nc	덤덤
데데	nc	데데
도도	nc	도도
도톰	nc	도톰
독특	nc	독특
돈독	nc	돈독
동그스름	nc	동그스름
동일	nc	동일
두둑	nc	두둑
두루뭉수리	nc	두루뭉수리
두툼	nc	두툼
둔중	nc	둔중
둔탁	nc	둔탁
둥글넓적	nc	둥글넓적
뒤숭숭	nc	뒤숭숭
드라마틱	nc	드라마틱
든든	nc	든든
듬직	nc	듬직
등등	nc	등등
등한	nc	등한
따끈	nc	따끈
따끔	nc	따끔
따듯	nc	따듯
따땃	nc	따땃
따뜻	nc	따뜻
따분	nc	따분
따사	nc	따사
따스	nc	따스
딱딱	nc	딱딱
딴딴	nc	딴딴
땅딸	nc	땅딸
땅딸막	nc	땅딸막
떠들석	nc	떠들석
떠들썩	nc	떠들썩
떨떠름	nc	떨떠름
떳떳	nc	떳떳
또렷	nc	또렷
똑똑	nc	똑똑
똘똘	nc	똘똘
뚜렷	nc	뚜렷
뚱뚱	nc	뚱뚱
뜨끈	nc	뜨끈
뜨끔	nc	뜨끔
뜨뜻	nc	뜨뜻
뜨뜻미지근	nc	뜨뜻미지근
뜨악	nc	뜨악
뜸	nc	뜸
마다	nc	마다
마땅	nc	마땅
마뜩	nc	마뜩
막론	nc	막론
막막	nc	막막
막역	nc	막역
막연	nc	막연
막중	nc	막중
만만	nc	만만
만무	nc	만무
만발	nc	만발
만연	nc	만연
말끔	nc	말끔
말랑	nc	말랑
말쑥	nc	말쑥
말짱	nc	말짱
망극	nc	망극
망연	nc	망연
망측	nc	망측
망칙	nc	망칙
맞이	nc	맞이
매끈	nc	매끈
매정	nc	매정
매캐	nc	매캐
맹	nc	맹
맹랑	nc	맹랑
맹렬	nc	맹렬
맹맹	nc	맹맹
맹숭맹숭	nc	맹숭맹숭
머쓱	nc	머쓱
먹먹	nc	먹먹
멀똥	nc	멀똥
멀뚱	nc	멀뚱
멀쑥	nc	멀쑥
멀쩡	nc	멀쩡
멍멍	nc	멍멍
멍청	nc	멍청
면	nc	면
면구	nc	면구
면면	nc	면면
면밀	nc	면밀
멸	nc	멸
명랑	nc	명랑
명료	nc	명료
명명백백	nc	명명백백
명민	nc	명민
명백	nc	명백
명석	nc	명석
명징	nc	명징
명철	nc	명철
명쾌	nc	명쾌
명확	nc	명확
모호	nc	모호
못마땅	nc	못마땅
몽롱	nc	몽롱
묘연	nc	묘연
무결	nc	무결
무관	nc	무관
무구	nc	무구
무궁	nc	무궁
무난	nc	무난
무던	nc	무던
무덤덤	nc	무덤덤
무도	nc	무도
무득	nc	무득
무뚝뚝	nc	무뚝뚝
무료	nc	무료
무모	nc	무모
무방	nc	무방
무색	nc	무색
무성	nc	무성
무수	nc	무수
무시무시	nc	무시무시
무엄	nc	무엄
무욕	nc	무욕
무이	nc	무이
무익	nc	무익
무자력	nc	무자력
무잡	nc	무잡
무정	nc	무정
무지근	nc	무지근
무지막지	nc	무지막지
무참	nc	무참
무해	nc	무해
묵묵	nc	묵묵
묵직	nc	묵직
문약	nc	문약
물컹	nc	물컹
뭉클	nc	뭉클
뭉툭	nc	뭉툭
미끈	nc	미끈
미련	nc	미련
미묘	nc	미묘
미미	nc	미미
미세	nc	미세
미숙	nc	미숙
미안	nc	미안
미욱	nc	미욱
미지근	nc	미지근
미진	nc	미진
미흡	nc	미흡
민감	nc	민감
민둥	nc	민둥
민망	nc	민망
민첩	nc	민첩
믿음직	nc	믿음직
밀밀	nc	밀밀
밋밋	nc	밋밋
바람직	nc	바람직
박	nc	박
박절	nc	박절
박정	nc	박정
반듯	nc	반듯
반반	nc	반반
발그스름	nc	발그스름
발랄	nc	발랄
발칙	nc	발칙
방대	nc	방대
방만	nc	방만
방불	nc	방불
방자	nc	방자
방정	nc	방정
버젓	nc	버젓
번다	nc	번다
번드레	nc	번드레
번듯	nc	번듯
번쇄	nc	번쇄
번잡	nc	번잡
범박	nc	범박
범상	nc	범상
범연	nc	범연
벙벙	nc	벙벙
변변	nc	변변
병약	nc	병약
복잡	nc	복잡
복잡다단	nc	복잡다단
본격	nc	본격
부	nc	부
부단	nc	부단
부당	nc	부당
부박	nc	부박
부산	nc	부산
부정당	nc	부정당
분망	nc	분망
분명	nc	분명
분분	nc	분분
분주	nc	분주
불가피	nc	불가피
불과	nc	불과
불구	nc	불구
불그레	nc	불그레
불길	nc	불길
불리	nc	불리
불미	nc	불미
불민	nc	불민
불사	nc	불사
불순	nc	불순
불쌍	nc	불쌍
불온	nc	불온
불쾌	nc	불쾌
불효막심	nc	불효막심
붉으스레	nc	붉으스레
비겁	nc	비겁
비근	nc	비근
비등	nc	비등
비롯	nc	비롯
비루	nc	비루
비릿	nc	비릿
비범	nc	비범
비스듬	nc	비스듬
비슷	nc	비슷
비슷비슷	nc	비슷비슷
비열	nc	비열
비장	nc	비장
비졸	nc	비졸
비천	nc	비천
빈번	nc	빈번
빈정	nc	빈정
빈한	nc	빈한
빠듯	nc	빠듯
빡빡	nc	빡빡
빳빳	nc	빳빳
빵빵	nc	빵빵
빽빽	nc	빽빽
뻐근	nc	뻐근
뻐덩	nc	뻐덩
뻔	nc	뻔
뻔뻔	nc	뻔뻔
뻣뻣	nc	뻣뻣
뾰로통	nc	뾰로통
뿌듯	nc	뿌듯
삐딱	nc	삐딱
사소	nc	사소
사특	nc	사특
삭막	nc	삭막
산뜻	nc	산뜻
산란	nc	산란
산만	nc	산만
살기등등	nc	살기등등
살벌	nc	살벌
삼삼	nc	삼삼
삼엄	nc	삼엄
삽상	nc	삽상
상냥	nc	상냥
상세	nc	상세
상이	nc	상이
상쾌	nc	상쾌
상큼	nc	상큼
새촘	nc	새촘
생경	nc	생경
생생	nc	생생
생소	nc	생소
서늘	nc	서늘
서먹	nc	서먹
서먹서먹	nc	서먹서먹
서서	nc	서서
서슴	nc	서슴
서운	nc	서운
석연	nc	석연
선량	nc	선량
선명	nc	선명
선선	nc	선선
선연	nc	선연
섬세	nc	섬세
섭섭	nc	섭섭
성급	nc	성급
세련	nc	세련
세밀	nc	세밀
세세	nc	세세
세심	nc	세심
섹시	nc	섹시
센세이셔널	nc	센세이셔널
소담	nc	소담
소략	nc	소략
소박	nc	소박
소상	nc	소상
소소	nc	소소
소심	nc	소심
소중	nc	소중
속	nc	속
속상	nc	속상
솔깃	nc	솔깃
솔직	nc	솔직
송구	nc	송구
수다	nc	수다
수더분	nc	수더분
수두룩	nc	수두룩
수려	nc	수려
수북	nc	수북
수상	nc	수상
수수	nc	수수
수월	nc	수월
수척	nc	수척
숙연	nc	숙연
순결무구	nc	순결무구
순박	nc	순박
순전	nc	순전
순진	nc	순진
순진무구	nc	순진무구
순탄	nc	순탄
숭고	nc	숭고
쉬쉬	nc	쉬쉬
스산	nc	스산
습습	nc	습습
시급	nc	시급
시끌	nc	시끌
시들	nc	시들
시무룩	nc	시무룩
시시	nc	시시
시시껄렁	nc	시시껄렁
시원	nc	시원
시큰	nc	시큰
시큰둥	nc	시큰둥
시큼	nc	시큼
시퉁	nc	시퉁
식상	nc	식상
신기	nc	신기
신랄	nc	신랄
실팍	nc	실팍
심각	nc	심각
심대	nc	심대
심드렁	nc	심드렁
심란	nc	심란
심상	nc	심상
심심	nc	심심
심약	nc	심약
심오	nc	심오
싱싱	nc	싱싱
싸늘	nc	싸늘
싸아	nc	싸아
쌀쌀	nc	쌀쌀
썰렁	nc	썰렁
쏠쏠	nc	쏠쏠
쓸쓸	nc	쓸쓸
씁쓰름	nc	씁쓰름
씁쓸	nc	씁쓸
씨니컬	nc	씨니컬
씩씩	nc	씩씩
아늑	nc	아늑
아둔	nc	아둔
아득	nc	아득
아뜩	nc	아뜩
아련	nc	아련
아리송	nc	아리송
아릿	nc	아릿
아이러니컬	nc	아이러니컬
아찔	nc	아찔
안이	nc	안이
알뜰	nc	알뜰
알량	nc	알량
암담	nc	암담
앙상	nc	앙상
애돌애돌	nc	애돌애돌
애매	nc	애매
애매모호	nc	애매모호
애잔	nc	애잔
애절	nc	애절
애틋	nc	애틋
야릇	nc	야릇
야박	nc	야박
야비	nc	야비
야트막	nc	야트막
얄얄	nc	얄얄
얄팍	nc	얄팍
어눌	nc	어눌
어두컴컴	nc	어두컴컴
어둑	nc	어둑
어둑신	nc	어둑신
어둠침침	nc	어둠침침
어둠컴컴	nc	어둠컴컴
어떠	nc	어떠
어떠어떠	nc	어떠어떠
어렴풋	nc	어렴풋
어리둥절	nc	어리둥절
어리벙벙	nc	어리벙벙
어리숙	nc	어리숙
어마어마	nc	어마어마
어머어마	nc	어머어마
어색	nc	어색
어수록	nc	어수록
어수룩	nc	어수룩
어수선	nc	어수선
어슷	nc	어슷
어엿	nc	어엿
어정쩡	nc	어정쩡
어지간	nc	어지간
억울	nc	억울
얼떨떨	nc	얼떨떨
얼얼	nc	얼얼
얼큰	nc	얼큰
엄격	nc	엄격
엄밀	nc	엄밀
엄숙	nc	엄숙
엄연	nc	엄연
엄정	nc	엄정
엄중	nc	엄중
엄혹	nc	엄혹
엇비슥	nc	엇비슥
엇비슷	nc	엇비슷
엉뚱	nc	엉뚱
엉성	nc	엉성
엉큼	nc	엉큼
에로틱	nc	에로틱
여유만만	nc	여유만만
여의	nc	여의
여전	nc	여전
여차	nc	여차
여차여차	nc	여차여차
역력	nc	역력
연약	nc	연약
연연	nc	연연
열렬	nc	열렬
열악	nc	열악
영롱	nc	영롱
영리	nc	영리
영민	nc	영민
영악	nc	영악
영특	nc	영특
예리	nc	예리
예민	nc	예민
예쁘장	nc	예쁘장
오묘	nc	오묘
오붓	nc	오붓
온건	nc	온건
온당	nc	온당
온순	nc	온순
온아	nc	온아
온전	nc	온전
온화	nc	온화
옴팡	nc	옴팡
옹색	nc	옹색
옹졸	nc	옹졸
와일드	nc	와일드
왁자	nc	왁자
완강	nc	완강
완고	nc	완고
완곡	nc	완곡
완만	nc	완만
완연	nc	완연
왕성	nc	왕성
왜소	nc	왜소
외람	nc	외람
요긴	nc	요긴
요란	nc	요란
요만	nc	요만
용	nc	용
용감	nc	용감
용렬	nc	용렬
용의주도	nc	용의주도
용이	nc	용이
우람	nc	우람
우수	nc	우수
우아	nc	우아
우악	nc	우악
우직	nc	우직
울적	nc	울적
울창	nc	울창
움찔	nc	움찔
웅대	nc	웅대
웅장	nc	웅장
웅혼	nc	웅혼
원대	nc	원대
원만	nc	원만
원숙	nc	원숙
웬간	nc	웬간
웬만	nc	웬만
위대	nc	위대
위독	nc	위독
위세당당	nc	위세당당
위태	nc	위태
위태위태	nc	위태위태
유구	nc	유구
유들	nc	유들
유려	nc	유려
유력	nc	유력
유머러스	nc	유머러스
유명	nc	유명
유복	nc	유복
유사	nc	유사
유순	nc	유순
유약	nc	유약
유연	nc	유연
유용	nc	유용
유유	nc	유유
유익	nc	유익
유인	nc	유인
유창	nc	유창
유치	nc	유치
유쾌	nc	유쾌
육실	nc	육실
육중	nc	육중
융숭	nc	융숭
으늑	nc	으늑
으슥	nc	으슥
으젓	nc	으젓
은근	nc	은근
은밀	nc	은밀
은은	nc	은은
을씨년	nc	을씨년
음산	nc	음산
음습	nc	음습
음울	nc	음울
음침	nc	음침
음탕	nc	음탕
음험	nc	음험
음흔	nc	음흔
의미심장	nc	의미심장
의아	nc	의아
의연	nc	의연
의젓	nc	의젓
이러	nc	이러
이러이러	nc	이러이러
이러저러	nc	이러저러
이룩	nc	이룩
이상	nc	이상
이상야릇	nc	이상야릇
이악	nc	이악
익숙	nc	익숙
인자	nc	인자
일관	nc	일관
일목요연	nc	일목요연
일정	nc	일정
일천	nc	일천
자그마	nc	자그마
자명	nc	자명
자상	nc	자상
자세	nc	자세
자신만만	nc	자신만만
자욱	nc	자욱
자자	nc	자자
자자분	nc	자자분
자잘	nc	자잘
자질구레	nc	자질구레
작달막	nc	작달막
작작	nc	작작
잔인	nc	잔인
잔잔	nc	잔잔
잘룩	nc	잘룩
잠잠	nc	잠잠
잡다	nc	잡다
장구	nc	장구
장대	nc	장대
장렬	nc	장렬
장중	nc	장중
장쾌	nc	장쾌
장황	nc	장황
잦바듬	nc	잦바듬
쟁쟁	nc	쟁쟁
저돌	nc	저돌
저렴	nc	저렴
저만	nc	저만
저어	nc	저어
저열	nc	저열
저저	nc	저저
적나라	nc	적나라
적당	nc	적당
적대	nc	적대
적실	nc	적실
적적	nc	적적
적절	nc	적절
적합	nc	적합
적확	nc	적확
절묘	nc	절묘
절박	nc	절박
절실	nc	절실
절절	nc	절절
정갈	nc	정갈
정결	nc	정결
정교	nc	정교
정당	nc	정당
정대	nc	정대
정밀	nc	정밀
정연	nc	정연
정정당당	nc	정정당당
정중	nc	정중
정치	nc	정치
정확	nc	정확
조그마	nc	조그마
조급	nc	조급
조밀	nc	조밀
조속	nc	조속
조악	nc	조악
조용	nc	조용
조잡	nc	조잡
조촐	nc	조촐
졸렬	nc	졸렬
죄송	nc	죄송
주도면밀	nc	주도면밀
주요	nc	주요
준엄	nc	준엄
준열	nc	준열
중대	nc	중대
중요	nc	중요
중차대	nc	중차대
중후	nc	중후
즐비	nc	즐비
지극	nc	지극
지긋	nc	지긋
지긋지긋	nc	지긋지긋
지당	nc	지당
지대	nc	지대
지독	nc	지독
지리	nc	지리
지엄	nc	지엄
지저분	nc	지저분
진귀	nc	진귀
진기	nc	진기
진득	nc	진득
진부	nc	진부
진솔	nc	진솔
진정	nc	진정
진지	nc	진지
진진	nc	진진
질박	nc	질박
질척	nc	질척
질퍽	nc	질퍽
질펀	nc	질펀
집요	nc	집요
짜릿	nc	짜릿
짤막	nc	짤막
짧달막	nc	짧달막
짧막	nc	짧막
짭짤	nc	짭짤
째째	nc	째째
쩨쩨	nc	쩨쩨
쪼잔	nc	쪼잔
쫄깃	nc	쫄깃
찌릿	nc	찌릿
찌뿌두둥	nc	찌뿌두둥
찜찜	nc	찜찜
차분	nc	차분
착실	nc	착실
착잡	nc	착잡
착찹	nc	착찹
찬란	nc	찬란
찬연	nc	찬연
찬찬	nc	찬찬
참담	nc	참담
참신	nc	참신
참혹	nc	참혹
창백	nc	창백
창창	nc	창창
처량	nc	처량
처연	nc	처연
처절	nc	처절
처참	nc	처참
척박	nc	척박
철저	nc	철저
첨예	nc	첨예
청명	nc	청명
청아	nc	청아
청청	nc	청청
초라	nc	초라
초연	nc	초연
초췌	nc	초췌
촉박	nc	촉박
촉촉	nc	촉촉
촘촘	nc	촘촘
추레	nc	추레
추례	nc	추례
추악	nc	추악
추잡	nc	추잡
축축	nc	축축
출중	nc	출중
출출	nc	출출
충분	nc	충분
충직	nc	충직
취약	nc	취약
치기만만	nc	치기만만
치렁	nc	치렁
치밀	nc	치밀
치사	nc	치사
치열	nc	치열
칙칙	nc	칙칙
친근	nc	친근
칠칠	nc	칠칠
침울	nc	침울
침침	nc	침침
침통	nc	침통
카랑	nc	카랑
캄캄	nc	캄캄
컴컴	nc	컴컴
쾌적	nc	쾌적
쾌청	nc	쾌청
쾌활	nc	쾌활
퀭	nc	퀭
퀴퀴	nc	퀴퀴
큼지막	nc	큼지막
큼직	nc	큼직
큼큼	nc	큼큼
타당	nc	타당
탁월	nc	탁월
탄탄	nc	탄탄
탐탁	nc	탐탁
텁수룩	nc	텁수룩
텁텁	nc	텁텁
토옥	nc	토옥
톡톡	nc	톡톡
통렬	nc	통렬
통쾌	nc	통쾌
투박	nc	투박
투철	nc	투철
특별	nc	특별
특이	nc	특이
특출	nc	특출
튼실	nc	튼실
튼튼	nc	튼튼
파르스름	nc	파르스름
파리	nc	파리
팍팍	nc	팍팍
판이	nc	판이
판판	nc	판판
팽팽	nc	팽팽
펑퍼짐	nc	펑퍼짐
편편	nc	편편
평범	nc	평범
평이	nc	평이
평평	nc	평평
포근	nc	포근
폭신	nc	폭신
푸근	nc	푸근
푸르무레	nc	푸르무레
푸르스름	nc	푸르스름
푸석	nc	푸석
푸짐	nc	푸짐
푹신	nc	푹신
풋풋	nc	풋풋
풍부	nc	풍부
풍성	nc	풍성
풍족	nc	풍족
핍진	nc	핍진
하구	nc	하구
한가	nc	한가
한미	nc	한미
한산	nc	한산
한심	nc	한심
한유	nc	한유
한적	nc	한적
합당	nc	합당
항구	nc	항구
해괴	nc	해괴
해괴망측	nc	해괴망측
해박	nc	해박
해사	nc	해사
향긋	nc	향긋
허구	nc	허구
허다	nc	허다
허랑방탕	nc	허랑방탕
허름	nc	허름
허망	nc	허망
허술	nc	허술
허약	nc	허약
허전	nc	허전
허허	nc	허허
허황	nc	허황
헌출	nc	헌출
헐렁	nc	헐렁
헐직	nc	헐직
험난	nc	험난
험악	nc	험악
험준	nc	험준
헛	nc	헛
헛헛	nc	헛헛
혁혁	nc	혁혁
현격	nc	현격
현란	nc	현란
현저	nc	현저
협소	nc	협소
호방	nc	호방
호젓	nc	호젓
호쾌	nc	호쾌
호탕	nc	호탕
혹독	nc	혹독
혹심	nc	혹심
혼곤	nc	혼곤
혼재	nc	혼재
혼탁	nc	혼탁
홀가분	nc	홀가분
홀쭉	nc	홀쭉
화급	nc	화급
화기애애	nc	화기애애
화려	nc	화려
화창	nc	화창
확고	nc	확고
확실	nc	확실
확연	nc	확연
활달	nc	활달
활발	nc	활발
황공	nc	황공
황급	nc	황급
황당	nc	황당
황당무계	nc	황당무계
황량	nc	황량
황막	nc	황막
황무	nc	황무
황송	nc	황송
황폐	nc	황폐
황홀	nc	황홀
황황	nc	황황
횅댕그렁	nc	횅댕그렁
획기	nc	획기
획일	nc	획일
후덥지근	nc	후덥지근
후련	nc	후련
후줄근	nc	후줄근
후텁지근	nc	후텁지근
훈훈	nc	훈훈
훌륭	nc	훌륭
훤출	nc	훤출
훤칠	nc	훤칠
휘황	nc	휘황
휘황찬란	nc	휘황찬란
흉맹	nc	흉맹
흉악	nc	흉악
흉칙	nc	흉칙
흉포	nc	흉포
흉흉	nc	흉흉
흐리멍덩	nc	흐리멍덩
흐릿	nc	흐릿
흐뭇	nc	흐뭇
흔쾌	nc	흔쾌
흥건	nc	흥건
흥미진진	nc	흥미진진
희귀	nc	희귀
희끄무레	nc	희끄무레
희끗	nc	희끗
희미	nc	희미
희박	nc	희박
희한	nc	희한
구백	nn	구백
구십	nn	구십
기백만	nn	기백만
기십만	nn	기십만
기천	nn	기천
너댓	nn	너댓
너더댓	nn	너더댓
너덧	nn	너덧
네댓	nn	네댓
네째	nn	네째
다섯	nn	다섯
다섯째	nn	다섯째
대여섯	nn	대여섯
두셋	nn	두셋
두엇	nn	두엇
둘	nn	둘
둘째	nn	둘째
륙	nn	륙
마흔	nn	마흔
백만	nn	백만
백억	nn	백억
사만	nn	사만
사십	nn	사십
사오만	nn	사오만
사오십	nn	사오십
삼만	nn	삼만
삼백만	nn	삼백만
삼사만	nn	삼사만
삼사천	nn	삼사천
삼십	nn	삼십
삼십만	nn	삼십만
삼천	nn	삼천
서넛	nn	서넛
서른	nn	서른
세째	nn	세째
셋	nn	셋
셋째	nn	셋째
수만	nn	수만
수백	nn	수백
수백만	nn	수백만
수백억	nn	수백억
수십	nn	수십
수십만	nn	수십만
수십억	nn	수십억
수십조	nn	수십조
수억	nn	수억
수천만	nn	수천만
수천억	nn	수천억
쉰	nn	쉰
스물	nn	스물
십	nn	십
십만	nn	십만
십수	nn	십수
십억	nn	십억
십오	nn	십오
십오만	nn	십오만
십팔	nn	십팔
아홉	nn	아홉
아홉째	nn	아홉째
아흔	nn	아흔
억만	nn	억만
여남은	nn	여남은
여덟	nn	여덟
여덟째	nn	여덟째
여든	nn	여든
여만	nn	여만
여섯	nn	여섯
여섯째	nn	여섯째
열다섯	nn	열다섯
열댓	nn	열댓
열두	nn	열두
열여덟	nn	열여덟
열여섯	nn	열여섯
예닐곱	nn	예닐곱
예순	nn	예순
오백	nn	오백
오백만	nn	오백만
오십	nn	오십
오십만	nn	오십만
육만	nn	육만
육백	nn	육백
육십	nn	육십
육십만	nn	육십만
육천	nn	육천
이백만	nn	이백만
이삼	nn	이삼
이삼십	nn	이삼십
이삼십만	nn	이삼십만
이십	nn	이십
이십구	nn	이십구
이십만	nn	이십만
이천만	nn	이천만
일고여덟	nn	일고여덟
일곱	nn	일곱
일곱째	nn	일곱째
일만	nn	일만
일백	nn	일백
일백만	nn	일백만
일억	nn	일억
일천만	nn	일천만
일흔	nn	일흔
즈믄	nn	즈믄
천억	nn	천억
첫째	nn	첫째
칠만	nn	칠만
칠백	nn	칠백
칠백만	nn	칠백만
칠십	nn	칠십
칠십만	nn	칠십만
칠천	nn	칠천
칠팔	nn	칠팔
칠팔십	nn	칠팔십
팔만	nn	팔만
팔백	nn	팔백
팔십	nn	팔십
팔천	nn	팔천
하낫	nn	하낫
한둘	nn	한둘
걔	np	걔
거기	np	거기
거시기	np	거시기
고것	np	고것
고놈	np	고놈
그거	np	그거
그것	np	그것
그곳	np	그곳
그기	np	그기
그녀	np	그녀
그년	np	그년
그놈	np	그놈
그대	np	그대
그분	np	그분
그이	np	그이
그자	np	그자
그쪽	np	그쪽
그편	np	그편
너	np	너
너거	np	너거
너희	np	너희
네놈	np	네놈
누구 누구	np	누구누구
누구누구	np	누구누구
느이	np	느이
늬	np	늬
모모	np	모모
무엇	np	무엇
뭣	np	뭣
어데	np	어데
여러분	np	여러분
요것	np	요것
요년	np	요년
요노옴	np	요노옴
요놈	np	요놈
이것	np	이것
이곳	np	이곳
이년	np	이년
이놈	np	이놈
이눔	np	이눔
자네	np	자네
쟤	np	쟤
저거	np	저거
저것	np	저것
저곳	np	저곳
저그	np	저그
저년	np	저년
저놈	np	저놈
저쪽	np	저쪽
저편	np	저편
저희	np	저희
제군	np	제군
형씨	np	형씨
께	xs	께
네	xs	네
답	xs	답
되	xs	되
들이	xs	들이
롭	xs	롭
률	xs	률
바기	xs	바기
스럽	xs	스럽
장이	xs	장이
쟁이	xs	쟁이
짜리	xs	짜리
째	xs	째
투성이	xs	투성이
하	xs	하
허	xs	허
